sense	pos	Concepticon_ID	Concepticon_Gloss
Aai	<none>		
Ehemann	Noun, common, masculine	1200	HUSBAND
Vater	Foreign word	1217	FATHER
Abeileni	Noun, proper		
Abia	Noun, proper		
Abiaþar	Noun, proper		
Abraham	Noun, proper		
vor Furcht, Staunen außer sich geraten über	Verb		
stark, heftig	Adjective	785	STRONG
sehr	Adverb, Comparative	1311	VERY
von, von __ weg, von __ her	<none>	693	FROM
Adam	Noun, proper		
Addei	Noun, proper		
Addin	Noun, proper		
Adoneikam	Noun, proper		
von, von __ weg, von __ her	Preposition, +D	693	FROM
nachher	Adverb	1685	AFTER
Nachkomme	Noun, common, masculine		
der folgende Tag	Noun, common, masculine		
des Nachsabbats dh des ersten Wochentags	Noun, common		
geplagt	Participle, past		
Verdammung	Noun, common, feminine		
Trunkenbold	Noun, common, masculine		
Fresser	Noun, common, masculine		
Abgrund	Noun, common, feminine		
Gottlosigkeit	Noun, common, feminine		
abgöttisch, gottlos	Adjective		
der Heimat fern	Adjective		
Ablegung, Erlaß	Noun, common, feminine		
Erlaß	Noun, common, neuter		
Betrug	Noun, common, feminine		
ermüdet	Participle, past	1757	TIRED
Absetzung	Noun, common, feminine		
Abfall	Noun, common, feminine		
hinten	Adverb, locative		
von hinten	Adverb, directional		
von hinten	Adverb		
wieder	Adverb	204	AGAIN
Wiederanfang, Wiedererneuerung	Noun, common, feminine		
letzter	Adjective, Comparative	1529	LAST (FINAL)
letzter	Adjective, Superlative	1529	LAST (FINAL)
furchtlos	Verb		
Agar	Noun, proper		
Engel, Bote	Noun, common, masculine		
Bedrängnis 	Noun, common, feminine		
bedrängen	Verb		
eng	Adjective	3053	TIGHT
Furcht, Schrecken	Noun, common, neuter		
ängstigen	Verb		
einen anfahren	Verb		
einen erschrecken	Verb		
Unzucht	Noun, common, feminine		
schmutzig gewinnsüchtig	Adjective		
Unzucht	Noun, common, neuter		
Schandrede	Noun, common, feminine		
Drangsal	Noun, common, feminine		
 bedrängen	Verb		
Drangsal	Noun, common, feminine		
schimpflich	Adjective		
schwierig	Adjective	584	DIFFICULT
agluba	Adverb, Comparative		
Agustus	Noun, proper		
Sinn, Verstand	Noun, common, masculine	2950	MEANING
zahme  Taube	Noun, common		
Spreu	Noun, common, feminine		
Aharon	Noun, proper		
meinen	Verb		
Geist	Noun, common, masculine	53	SPIRIT
Inspiration	Noun, common, feminine		
geistig, geistlich	Adjective		
Ähre	Noun, common, neuter	3244	EAR (OF GRAIN)
acht	Numeral, cardinal	1705	EIGHT
achttägig	Adjective		
achtzig	Numeral, cardinal	1722	EIGHTY
der achte	Numeral, cardinal		
Fluß, Gewässer	Noun, common, feminine		
[Aia]	Noun, proper		
Aibair	Noun, proper		
Opfergabe	Noun, common		
Aiddua	Noun, proper		
Aieira	Noun, proper		
Aifaisius	Noun, proper		
Aifaiso	Noun, proper		
öffne dich	Foreign word		
haben	Verb	773	HAVE
teilhaben an	Verb		
Eigentum	Noun, common, neuter		
In Besitz nehmen	Verb		
betteln; für sich verlangen	Verb	3534	BEG
Gebet	Noun, common, feminine		
Eigentum	Noun, common, feminine		
Dornstrauch	Noun, common, feminine		
leugnen	Verb	755	DENY
Gemeinde, Kirche; Gotteshaus	Noun, common, feminine	1349	CHURCH
Ailam	Noun, proper		
Aileiaizair	Noun, proper		
Aileiakeim	Noun, proper		
Aileisabaiþ	Noun, proper		
ailoe	Foreign word		
[Ailul]	<none>		
Aimmeira	Noun, proper		
eingeboren	Noun, common, masculine		
einzig	Adjective		
vereinzelt, alleinstehend	Adjective		
Einheit, Einmütigkeit	Noun, common, feminine		
vereinzeln, trennen	Verb	1359	SEPARATE
Einfalt	Noun, common, feminine		
einfach	Adjective	686	EASY
einfältig	Adverb, Comparative		
ein jeder	Pronoun, indefinite		
jeder von beiden	Pronoun, indefinite		
elf	Numeral, cardinal	1706	ELEVEN
Ainnaa	Noun, proper		
Ainok	Noun, proper		
Ainos	Noun, proper		
ains	Adjective		
niemand, keiner	Pronoun, indefinite	3887	NOBODY
Aiodia	Noun, proper		
Aipafras	Noun, proper		
Aipafraudeitus	Noun, proper		
Bischofsamt	Noun, common, feminine		
Bischof	Noun, common, masculine		
Brief	Noun, common	1612	LETTER
früh	Adverb, temporal	672	EARLY
längst, eher	Adverb, Comparative		
Airastus	Noun, proper		
Gesandter sein, unterhandeln	Verb		
Vorfahren	Adjective, Comparative		
heilig	Adjective	1702	HOLY
Lauterkeit, Echtheit	Noun, common, feminine		
Airmodam	Noun, proper		
Airmogaineis	Noun, proper		
Erde, Land	Noun, common, feminine	1228	EARTH (SOIL)
von irdischer Abkunft	Adjective		
irdisch	Adjective		
Bote	Noun, common, masculine		
Irrlehre	Noun, common, feminine		
irre geführt	Adjective		
Irrlehre	Noun, common, feminine		
irre führen	Verb		
irre machen	Verb		
sich scheuen vor	Verb		
sich scheuen vor	Verb		
Mutter	Noun, common, feminine	1216	MOTHER
Eid	Noun, common, masculine		
oder	Conjunction	1014	OR
Evangelium	Noun, common, neuter		
aiwaggelista	Noun, common, masculine		
das Evangelium verkünden	Verb		
Evangelium	Noun, common, feminine		
ewig	Adjective		
Schande	Noun, common, neuter		
schändlich handeln	Verb		
beschämen, beschimpfen	Verb		
sich anstrengen	Verb		
Segen 	Noun, common, masculine		
Aiwneikai	Noun, proper		
Zeit, Ewigkeit	Noun, common, masculine	892	TIME
Aiwwa	Noun, proper		
Dank	Noun, common		
Erz	Noun, common, neuter		
Aizaikeia	Noun, proper		
Erzschmied	Noun, common, masculine		
Aizleim	Noun, proper		
Aizor	Noun, proper		
Ewigkeit	Noun, common, feminine		
sondern	Conjunction		
Akaja	Noun, proper		
Akajus	Noun, proper		
Akaïkus	Noun, proper		
aber	Conjunction	3843	BUT
Essig	Noun, common		
Frucht	Noun, common, neuter	1507	FRUIT
unfruchtbar	Adjective		
Acker	Noun, common, masculine	212	FIELD
Akwla	Noun, proper		
Salbenbüchse aus Alabaster	Noun, common		
Brandopfer	Noun, common, feminine		
Alaiksandrus	Noun, proper		
insgesamt	Adverb		
Gesamtheit der Menschen	Noun, common, masculine		
alamannans	<none>		
Alamod	Noun, proper		
wachsen	Verb	479	GROW
an allem Mangel leidend	Adjective		
Alter	Noun, common	1789	AGE
Menschenalter, Zeit	Noun, common, feminine	892	TIME
Elle	Noun, common, feminine		
Öl	Noun, common, neuter	1484	OIL (ORGANIC SUBSTANCE)
Ölbaum	Noun, common, masculine		
Öl	Adjective	1484	OIL (ORGANIC SUBSTANCE)
Alfaius	Noun, proper		
Tempel	Noun, common, feminine		
außer	Conjunction		
anderswoher stammend	Adjective		
anders	Adverb	2504	DIFFERENT
anders	Adverb, Comparative	2504	DIFFERENT
anders gebildet, allegorisch	Participle, past		
mästen	Verb		
Eifer	Noun, common, neuter		
eifern	Verb		
zornig machen	Verb		
anderswo	Adverb, locative		
anderswohin	Adverb, directional		
anderswoher	Adverb, directional		
ein andrer	Adjective		
völlig	Adverb		
von allen Seiten her	Adverb, directional		
vollkommen	Noun, common, masculine		
Redlichkeit	Noun, common, feminine		
überhaupt	Adverb		
all, jeder, ganz	Adjective	2277	WHOLE
Allmächtiger	Noun, common, masculine		
alt werden	Verb		
alt	Adjective	1229	OLD
[Alul]	Noun, proper		
Ameinadab	Noun, proper		
amen	Foreign word		
Ammo	Noun, proper		
Schulter	Noun, common, masculine	1482	SHOULDER
amsa	Noun, common, masculine		
denn, nun	Particle		
darauf, außerdem	Adverb		
Gebot	Noun, common, feminine		
Empfehlung, Überlieferung	Noun, common, neuter		
in der Heimat befindlich	Adjective		
plötzlich	Adverb, temporal	2920	SUDDENLY
Lesung	Noun, common, feminine		
Auflegung	Noun, common, feminine		
Verborgenheit	Noun, common, feminine		
verborgen	Adjective		
auf gleiche Weise	Adverb		
Übermacht, Mißhandlung	Noun, common, feminine		
versteckte Meinung, vermutung	Noun, common, feminine		
ausatmen	Verb		
Ananias	Noun, proper		
Ananeias	<none>		
Erneuerung	Noun, common, feminine		
Ruhe	Noun, common	3458	SILENCE
Lästerung	Noun, common, feminine		
sichtbar	Adjective		
Anfang	Noun, common, feminine	1557	BEGINNING
anaþaima	Foreign word		
Anaþoþ	Noun, proper		
zukünftig	Adjective		
Billigkeit	Noun, common, feminine		
entlang, über __ hin, auf __ hin	Preposition, +A		
Lösegeld	Noun, common, feminine		
Tadel	Noun, common, neuter		
Antwort; Verteidigung	Noun, common, feminine		
Bekenntnis	Noun, common, neuter		
Gegenlohn; Vergeltung	Noun, common, neuter		
Abend	Noun, common, neuter	1629	EVENING
feindlich	Noun, common, masculine		
das Empfangen	Noun, common, neuter	694	GET
festhaltend	Adjective		
angenehm	Adjective		
Aufnahme, Annahme; Erhebung	Noun, common, feminine		
verabscheuungswert	Adjective		
Widersacher	Noun, common, masculine		
Gegner vor Gericht	Noun, common, masculine		
nüchtern, verständig	Adjective		
Antlitz	Noun, common, neuter	1560	FACE
freimütig, offen	Adverb	3235	OPEN (STATE)
offen	Adverb	3235	OPEN (STATE)
Preis	Noun, common, neuter	657	PRICE
Antwort	Noun, common, neuter		
Sold; Notdurft	Noun, common, feminine		
Angesicht	Noun, common, neuter		
Amt, Dienst	Noun, common, neuter	2430	OFFICE
etwas  leisten	Verb		
Diener	Noun, common, masculine		
Ende	Noun, common, masculine	742	END (OF SPACE)
Enthüllung, Offenbarung	Noun, common, feminine		
endlos	Adjective		
anders, sonst	Conjunction	2504	DIFFERENT
Andraias	Noun, proper		
Darbietung, Beistand	Noun, common, neuter		
Gegenwart, Angesicht, Person	Noun, common, neuter	683	PERSON
gegenwärtig	Adjective		
Anna	Noun, proper		
Annas	Noun, proper		
Sold	Noun, common, feminine		
Ano	Noun, proper		
Balken	Noun, common, masculine		
gnädig	Adjective		
Freude; Dank; Gnade, Gunst	Noun, common, feminine	2524	JOY
Antiaukia, Antiokia	Noun, proper		
anderer, zweiter	Adjective	1384	SECOND
Verschiedenheit	Noun, common, feminine		
anders	Adverb	2504	DIFFERENT
Appaullo	Noun, proper		
Apostolat	Noun, common, feminine		
Apostel	Noun, common, masculine		
Axt	Noun, common, feminine	677	AXE
Aar	Noun, common, masculine		
Arabia	Noun, proper		
Araita	Noun, proper		
Aram	Noun, proper		
arbeiten; dulden	Verb	1086	WORK (ACTIVITY)
seine Ehre setzen in, trachten nach	Verb		
mit Jem arbeiten; mit Jem leiden	Verb		
dúrcharbeiten	Verb		
Arbeit, Drangsal	Noun, common, feminine	984	WORK (LABOUR)
das Erbe	Noun, common, neuter		
der Erbe	Noun, common, masculine		
der Erbe	Noun, common, masculine		
Erbin	Noun, common, feminine		
Areimaþaia	Noun, proper		
Areistarkus	Noun, proper		
Arfaksad	Noun, proper		
Pfeil	Noun, common, feminine	977	ARROW
pflügen	Verb	1921	PLOUGH
hölzerner Kasten, Arche; Futteral, Beutel	Noun, common, feminine	2951	POUCH
Erzengel	Noun, common, masculine		
Arkippus	Noun, proper		
Barmherzigkeit	Noun, common, feminine		
Almosen	Noun, common, feminine		
barmherzig	Adjective		
Barmherzigkeit	Noun, common, feminine		
sich eines erbarmen	Verb		
sich eines erbarmen	Verb		
arm, beklagenswert	Adjective	1674	POOR
Arm	Noun, common, masculine	1673	ARM
sicher	Adverb		
aromata	Noun, common		
[Artaksairksus]	Noun, proper		
umsonst	Adverb		
Asaf	Noun, proper		
Sommer	Noun, common, feminine	1342	SUMMER
Aser	Noun, proper		
Asgad	Noun, proper		
Asia	Noun, proper		
Eselsmühle	Noun, common, feminine		
Esel	Noun, common, masculine	1862	DONKEY
Asmoþ	Noun, proper		
Mietling, Tagelöhner	Noun, common, masculine		
Aß, Pfennig	Noun, common, masculine		
Assaum	Noun, proper		
Sicherheit	Noun, common		
Ast	Noun, common, masculine	1531	BRANCH
von	Preposition, +AD	693	FROM
Jahr	Noun, common, neuter	1226	YEAR
Ater, Ateir	Noun, proper		
Zugang	Noun, common, neuter		
Saat	Noun, common	714	SEED
zum Essen austeilen	Verb		
Vater	Noun, common, masculine	1217	FATHER
das Beobachten	Noun, common, feminine		
Aþeinim	Noun, proper		
Jahre	Noun, common		
aber doch	Conjunction		
Seligkeit	Noun, common, feminine		
selig preisen	Verb		
selig	Adjective		
beglückt	Adjective		
allerdings; wohl; vielleicht	Adverb	2278	PERHAPS
Fenster	Noun, common, neuter	1375	WINDOW
zeigen	Verb	1039	SHOW
einem  zeigen	Verb		
Auge	Noun, common, neuter	1248	EYE
Lärm	Noun, common, masculine	1182	NOISE
lärmen	Verb	2895	MAKE NOISE
Ofen	Noun, common, masculine	859	STOVE
Ochse	Noun, common, masculine		
Ochse	Noun, common, masculine		
höher	Adjective, Comparative		
höchster	Adjective, Superlative		
denn, nämlich	Conjunction		
sich mehren	Verb		
hinzufügen zu	Verb		
hinzufügen	Verb	2882	ADD
sich vermehren, zunehmen	Verb	1041	INCREASE
sich mehren	Verb		
sich vermehren, zunehmen	Verb	1041	INCREASE
Auneiseifaurus	Noun, proper		
Aunisimus	Noun, proper		
Grabdenkmäler, Gräber	Noun, common		
Schweißtuch	Noun, common, neuter		
Krug	Noun, common, masculine	270	JUG
aurkeis	Noun, common, masculine		
Garten	Noun, common, masculine	586	GARDEN
Landmann, Winzer	Noun, common, masculine		
Ohr	Noun, common, neuter	1247	EAR
Wüste	Noun, common, feminine	3687	DESERT
öde	Adjective		
auþs	<none>		
Schafherde	Noun, common, neuter		
einem  danken	Verb		
Dank	Noun, common, neuter		
Schafstall	Noun, common, neuter		
Großmutter	Noun, common, feminine	1496	GRANDMOTHER
Axaïa	<none>		
üppig lebend	Noun, common		
leicht	Adjective	1052	LIGHT (WEIGHT)
Asche	Noun, common, feminine	646	ASH
am Tage der ungesäuerten Brode	Noun, common		
wenn	Conjunction, enclitic		
Babawis	Noun, proper		
Bett	Noun, common, neuter	1663	BED
Bagauis	Noun, proper		
Baum	Noun, common, masculine	906	TREE
beide	Numeral, other		
Baiailzaibul	Noun, proper		
einen  zwingen	Verb		
einen  zwingen	Verb		
Baidsaiïdan	<none>		
Bailiam	Noun, proper		
Bainiamein	Noun, proper		
Maulbeerbaum	Noun, common, masculine		
tragen 	Verb	700	CARRY
bringen	Verb	692	BRING
hineinbringen	Verb		
vertragen	Verb		
vergleichen	Verb	3429	COMPARE
hindurchtragen	Verb		
hinaustragen; hervorbringen; vorbringen di antworten; ertragen	Verb	833	ENDURE
hinaustragen	Verb		
Beroia in Thrakien	Noun, proper		
Gebirgsgegend	Noun, common, feminine		
einen bergen, bewahren	Verb	1997	PRESERVE
einen bergen, bewahren	Verb	1997	PRESERVE
Helle	Noun, common, feminine		
offenbaren	Verb		
offenbaren	Verb		
hell, offenbar	Adjective	679	BRIGHT
offen	Adverb, Comparative	3235	OPEN (STATE)
Bitterkeit	Noun, common, feminine		
bitter	Adjective	887	BITTER
Baiþil	Noun, proper		
[Baiþlaem]	<none>		
Baiþsaïdan	<none>		
beide	Numeral, other		
Schlauch	Noun, common, masculine		
Hals, Nacken	<none>	1333	NECK
Salbe	Noun, common, neuter	1926	OINTMENT
kühn, freimütig	Adverb		
Kühnheit, Freimut	Noun, common, feminine		
kühn sein, wagen	Verb	1779	DARE
Bosheit	Noun, common, feminine		
Pein; Strafe; Folter	Noun, common, feminine		
martern	Verb		
Banauis	Noun, proper		
Band, Fessel	Noun, common, feminine	2969	RIBBON
Gefangener	Noun, common, masculine	1072	PRISONER
Zeichen	Noun, common, feminine	1720	SIGN
ein Zeichen, einen Wink geben, andeuten	Verb	1720	SIGN
durch Winke andeuten	Verb		
Zeichen	Noun, common, feminine	1720	SIGN
Schlag, Wunde	Noun, common, feminine	1109	WOUND
Scheuer	Noun, common, masculine		
Barabba	Noun, proper		
Barakeias	Noun, proper		
Nicht	Noun, common, masculine	1240	NOT
von Gerste bereitet	Adjective		
Busen, Schoß	Noun, common, masculine	1402	BREAST
Kind	Noun, common, neuter	2099	CHILD
Barnabas	Noun, proper		
Kindlein	Noun, common, neuter		
kindliches Wesen	Noun, common, feminine		
Kindheit	Noun, common, neuter		
kindlich	Adjective		
Barteimaiaus	Noun, proper		
Barþaulaumaius	Noun, proper		
fromm verehren	Verb		
Bassus	Noun, proper		
besser	Adjective		
batista	Adjective, Superlative		
Vorteil erlangen	Verb		
Batwins	Noun, proper		
Wohnung	Noun, common, feminine		
wohnen, bewohnen	Verb	363	DWELL (LIVE, RESIDE)
Wohnung aufschlagen	Verb		
Bauanairgais	Noun, proper		
Bauauz	Noun, proper		
ausfegen	Verb		
aufblasen	Verb		
der Geborene	Noun, common, masculine		
Bürger	Noun, common, masculine	1032	CITIZEN
Turm, Burg; Stadt	Noun, common, feminine	1391	TOWN
Stadtmauer	Noun, common, feminine		
Bürde	Noun, common, feminine		
stumm	Adjective	1666	MUTE
auf etwas warten	Verb		
ausharren, ertragen	Verb	833	ENDURE
erwarten	Verb		
Sauerteig	Noun, common, neuter		
durchsäuern	Verb		
beißen	Verb	1403	BITE
schelten, bedrohen	Verb	1192	THREATEN
Beroþ	Noun, proper		
Eltern	Noun, common, masculine	505	PARENTS
Beþania	Noun, proper		
Beþlaihaim	Noun, proper		
Beþsaeida	Noun, proper		
Beþsfagei	Noun, proper		
bei, um	Preposition, +AD	1461	AT
Lager	Noun, common, feminine	1105	CAMP
Bitte, Gebet; Anliegen, Aufforderung	Noun, common, feminine		
Bettler	Noun, common, masculine		
bitten, beten, betteln	Verb	1828	ASK (REQUEST)
beten, bitten	Verb	1828	ASK (REQUEST)
erbitten	Verb		
Übervorteilung	Noun, common, neuter		
Übervorteilung	Noun, common		
üble Nachrede	Noun, common, neuter		
Prahler	Noun, common, masculine		
woran	Adverb		
zugleich aber rüste auch	Participle, present		
Beschneidung	Noun, common, neuter		
einen mit etwas  binden	Verb		
lösen; auflösen, erklären; entbinden von	Verb	1626	EXPLAIN
umbinden mit 	Verb		
binden	Verb	1917	TIE
Gefahr	Noun, common, feminine	1810	DANGER
in Gefahr kommen	Noun, common		
Murren; Verleumdungen	Noun, common, feminine		
Nachstellung, Anschlag	Noun, common, feminine		
Eltern	<none>	505	PARENTS
Befleckung	Noun, common, feminine		
Anstoß	Noun, common, neuter		
ringsum	Adverb		
nachher, später	Adverb	1685	AFTER
entbieten, befehlen	Verb	1998	COMMAND
verbieten	Verb	83	FORBID
beugen; sich beugen	Verb		
beugen	Verb		
Gewohnheit	Noun, common, neuter		
gewohnt	Adjective		
Tisch	Noun, common, masculine	1775	TABLE
sich vermischen mit	Verb		
abschaffen	Verb		
abschaffen	Verb		
Wohlwollen, Güte	Noun, common, feminine		
barmherzig sein	Verb		
sich erbarmen	Verb		
barmherzig; dem Guten zugetan	Adjective		
aufblasen	Verb		
schlagen	Verb	3308	STRIKE (SOMEONE)
durchbleuen	Verb		
verblenden	Verb		
erblinden	Verb		
blind	Adjective	1653	BLIND
Blume	Noun, common, masculine	239	FLOWER
verehren	Verb	257	WORSHIP
Verehrung	Noun, common, masculine		
Blut	Noun, common, neuter	946	BLOOD
blutflüssig	Participle, present		
reiben, zerreiben	Verb	1449	RUB
Buchstabe	Noun, common, feminine	1024	CHARACTER
Schriftgelehrter; Schreiber	Noun, common, masculine		
Nutzen	Noun, common, feminine	2929	BENEFIT
nützen, bessern	Verb		
verbessern, herstellen	Verb	2886	PRODUCE
im Augenblick	Noun, common		
Breite	Noun, common, feminine	2536	BREADTH
ausbreiten nach	Verb		
breit	Adjective	1243	WIDE
Ringen, Ringkampf	Noun, common, feminine		
verbrennen	Verb	141	BURN (SOMETHING)
in Brand stecken	Verb		
bringen	Verb	692	BRING
brechen; zerstören	Verb	681	DESTROY
zerbrechen	Verb	2558	BREAK (CLEAVE)
verwerfen, verachten	Verb	2715	DESPISE
brennen	Verb	1428	BURNING
verbrennen	Verb	141	BURN (SOMETHING)
Fieber	Noun, common, feminine	1534	FEVER
Bruder	Noun, common, masculine	1262	BROTHER
Brüder	Noun, common, masculine		
Bruderliebe	Noun, common, feminine		
gebrauchen	Verb		
ausgebrochen werden	Verb		
brauchbar	Adjective		
Brustharnisch	Noun, common, feminine		
Brunnen	Noun, common, masculine	954	WELL
Brust	Noun, common, feminine	1592	CHEST
Bräutigam	Noun, common, masculine	3282	GROOM
Neuvermählte, Schwiegertochter	Noun, common, feminine	1057	DAUGHTER-IN-LAW
kaufen	Verb	1869	BUY
verkaufen für	Verb		
erkaufen	Verb		
entbunden werden	Verb		
feines Linnen	Noun, common		
was ihm bevorstand	Verb		
säugen	Verb	2472	SUCKLE (BREASTFEED, NURSE)
Tag	Noun, common, masculine	1225	DAY (NOT NIGHT)
Teig	Noun, common, masculine		
Daikapaulis	Noun, proper		
Teilnahme, Gemeinschaft	Noun, common, feminine		
teilen, zuteilen, mitteilen	Verb	1119	DIVIDE
abteilen, einen Teil abgeben 	Verb		
verteilen, zerteilen	Verb		
verteilen unter 	Verb		
zuteilen, zerteilen	Verb		
Teil	Noun, common, feminine	779	PART
Besessener	Noun, common, masculine		
Grube; Schlucht, Tal	Noun, common, masculine	2539	PIT (POTHOLE)
zu Tal, abwärts, nieder; auf die Erde	Adverb, directional	1326	DOWN
unten	Adverb, locative	721	LOW
von unten, unten	Adverb, directional	721	LOW
Dalmatia	Noun, proper		
Damaskon	Noun, proper		
verdämmen, versperren	Verb		
Taubheit	Noun, common, feminine		
Taubheit	Noun, common, feminine		
verstocken	Verb		
ertauben, verstockt werden	Verb		
sich beeifern	Verb		
taub, verstockt	Adjective	996	DEAF
Tochter	Noun, common, feminine	1357	DAUGHTER
Bewirtung	Noun, common, feminine		
geschunden, geplagt	<none>		
Geruch	Noun, common, feminine	3704	ODOR (SMELL)
Abwaschung	Noun, common, feminine		
taufen	Verb		
taufen	Verb		
Täufer	Noun, common, masculine		
 Tor	Noun, common, neuter	2940	GATE
Türhüterin	Noun, common, feminine		
Türhüterin	Noun, common, feminine		
Türhüter	Noun, common, masculine		
Dauriþaius	Noun, proper		
 Tor, Tür	Noun, common, feminine	1567	DOOR
sich erkühnen, wagen	Verb	1779	DARE
das Absterben	Noun, common, feminine		
töten	Verb	1417	KILL
töten	Verb	1417	KILL
Tod bringen, töten	Verb	1417	KILL
sterben	Verb	1494	DIE
mit sterben	Verb		
tot	Adjective	1625	DEAD
zum Tode bestimmt	Adjective		
Tod	Noun, common, masculine	910	DEATH
Daweid	Noun, proper		
Demas	Noun, proper		
Verleumderin	Noun, common, feminine		
Teufel	Noun, common, masculine		
diabulus	<none>		
Diakon	Noun, common, masculine		
Didimus	Noun, proper		
kneten, aus Ton bilden	Verb	274	KNEAD
kneten, aus Ton bilden	Verb	274	KNEAD
Fülle	Noun, common, feminine		
Zerstreuung	Noun, common, feminine		
Auflösung di Abmarsch, das Scheiden	Noun, common, feminine		
Tiefe	Noun, common, feminine	2534	DEPTH
Tiefe	Noun, common, feminine	2534	DEPTH
vertiefen	Verb		
tief	Adjective	1593	DEEP
wildes Tier	Noun, common, neuter		
sterben	Verb	1494	DIE
af-dobnan	Verb		
geplagt	<none>		
urteilen, beurteilen	Verb	1818	ADJUDICATE
beurteilen, verurteilen	Verb	484	CONDEMN
verurteilen	Verb	484	CONDEMN
urteilen, entscheiden	Verb	1818	ADJUDICATE
Ruhm	Noun, common, masculine		
aushauen	Verb		
tragen	Verb	700	CARRY
zusammentragen	Verb		
Trank	Noun, common, neuter	731	BEVERAGE
tränken mit	Verb		
tränken	Verb		
treiben; plagen	Verb	2868	DRIVE (CATTLE)
Drachme	Noun, common, masculine		
Brocken; Brosamen	Noun, common, feminine		
Feldzug	Noun, common, masculine		
Kriegsdienste tun, zu Felde ziehn	Verb		
Feldzug	Noun, common, neuter		
hinabstürzen	Verb		
hinabstürzen	Verb		
Brocken; Brosamen	<none>		
treiben	Verb	2868	DRIVE (CATTLE)
austreiben, vertreiben	Verb		
etwas trinken	Verb		
sich antrinken, betrinken	Verb		
trinken	Verb	1401	DRINK
zu Felde ziehen	Verb		
fallen	Verb	1280	FALL
fallen in	Verb		
einen  befallen	Verb		
hinfallen	Verb	2894	TUMBLE (FALL DOWN)
herausfallen	Verb		
Abhang	Noun, common, feminine	3076	SLOPE
trüben; irre machen; aufwiegeln	Verb		
Aufruhr	Noun, common, masculine		
unruhig werden	Verb		
in Bestürzung geraten	Verb		
in Bestürzung geraten	Verb		
Trunkenheit	Noun, common, feminine		
Schall	Noun, common, masculine		
Fall	Noun, common, masculine		
du	Adverb	1215	THOU
taugen	Verb		
wozu	Adverb		
Gläubiger	Noun, common, masculine		
Schuld	Noun, common	134	FAULT
ein Fest feiern	Verb		
Fest	Noun, common, feminine	131	FESTIVAL
verstummen	Verb		
stumm	Adjective	1666	MUTE
deshalb, deswegen, dazu	Unassigned		
Torenrede	Noun, common, feminine		
Torheit	Noun, common, feminine		
rasen	Verb		
töricht	Adjective		
Eeiram	Noun, proper		
da	Particle	1937	THERE
Eiaireiko	Noun, proper		
Eikaunion	Noun, proper		
Eisen	Noun, common, neuter	621	IRON
Eisenband, Kette	Noun, common, feminine	1627	CHAIN
eisern	Adjective		
daher somit	Conjunction		
eiþau	Unassigned		
Esaïas	Noun, proper		
Esaw	Noun, proper		
Vater	Noun, common, masculine	1217	FATHER
[Faddasur]	Noun, proper		
Abkunft, Geschlecht, Stamm	Noun, common, neuter	344	TREE TRUNK
Geschlecht	Noun, common, feminine		
sich freuen über	Verb		
sich mitfreuen	Verb		
geschickt, geeignet	Adjective	1824	DEXTEROUS
fangen, greifen	Verb	702	CATCH
ergreifen, erfassen , ertappen	Verb	855	SEIZE
Freude über	Noun, common, feminine		
Genüge leisten	Verb		
zubereiten	Verb	1100	COOK (SOMETHING)
tadeln	Verb		
übervorteilen	Verb		
übervorteilen	Verb		
Vermögen	Noun, common, neuter		
Habsucht	Noun, common, feminine		
habsüchtig, geldgierig	Adjective		
Habsucht	Noun, common, feminine		
geldgierig	Adjective		
Erwerb	Noun, common, neuter		
Habsucht	Noun, common, feminine		
Schuldner	Noun, common, masculine		
faihuþraihna	Noun, common		
Berg	Noun, common, neuter	639	MOUNTAIN
wehklagen	Verb		
Welt	Noun, common, masculine	965	WORLD
Schuld; Grund; Vorwurf	Noun, common, feminine	134	FAULT
tadeln	Verb		
alt	Adjective	1229	OLD
Alter	Noun, common, feminine	1789	AGE
vorjährig	Adjective		
fern	Adverb, locative	1406	FAR
von fern	Adverb, directional		
Schauspiel	Noun, common, neuter		
Ferse	Noun, common, feminine	980	HEEL
Falaig	Noun, proper		
Fallasur	<none>		
falten, zusammenrollen	Verb	1470	FOLD
Stück Zeug	Noun, common, masculine		
Schlamm	Noun, common, neuter	640	MUD
Fanuel	Noun, proper		
Farais	Noun, proper		
wandern, ziehen	Verb	1455	PULL
Farao	Noun, proper		
Fareisaius	Noun, proper		
fahren	Verb	741	DRIVE
einlaufen, landen	Verb	1922	LAND (DESCEND)
Binde	Noun, common		
halten, festhalten; beobachten, bewachen	Verb	1448	HOLD
behalten, bewahren	Verb	1997	PRESERVE
das Halten, der Dienst	Noun, common, neuter	1448	HOLD
Zaun	Noun, common, feminine	1690	FENCE
Fuchs	Noun, common, feminine	1312	FOX
sie vorzulegen	Adverb		
vor	Adverb	1883	IN FRONT OF
Straße	Noun, common, neuter	667	ROAD
Vorhaut	Noun, common, neuter		
Hausverwalter	Noun, common, masculine		
Verwaltung	Noun, common, neuter		
Verwalter	Noun, common, masculine		
Vorhang	Noun, common, neuter		
Vorsteher, Gebieter	Noun, common, masculine		
Oberbefehl	Noun, common, neuter		
Wunderzeichen	Noun, common, neuter		
Loskaufung, Erlösung	Noun, common, feminine		
Vorurteil	Noun, common, feminine		
Vorhang	Noun, common, neuter		
Furcht	Noun, common, feminine		
sich fürchten	Verb	1419	FEAR (BE AFRAID)
furchtsam	Adjective		
Vorlegung	Noun, common, feminine		
Vorsteher	Noun, common, masculine		
Faurtunatus	Noun, proper		
zuvor, früher	Adverb	1882	BEFORE
bevor	Conjunction		
wenige	Adjective	1242	FEW
sich erbarmen	Verb		
Seite, Gegend	Noun, common, feminine	682	SIDE
Aufpasser	Noun, common, masculine		
schmücken	Verb	1739	DECORATE
hasse, verabscheuen	<none>		
viertägig	Adjective		
vierfältig	Adjective		
das Amt des Vierfürsten	Noun, common, neuter		
vier	Numeral, cardinal	1500	FOUR
vierzehn	Numeral, cardinal	2451	FOURTEEN
Fingerring	Noun, common, neuter		
Finger	Noun, common, masculine	1303	FINGER
hasse, verabscheuen	Verb		
Feind	Noun, common, masculine	1358	ENEMY
Feindschaft	Noun, common, feminine		
um vieles, viel	Adverb	1198	MANY
Höhle	<none>	1155	CAVE
Filetus	Noun, proper		
verbergen	Verb	602	HIDE (CONCEAL)
verbergen vor	Verb		
übergeben, überliefern; verpachten; empfehlen	Verb		
begraben	Verb	1719	BURY
begraben	Verb	1719	BURY
Höhle	Noun, common, neuter	1155	CAVE
Filippai	Noun, proper		
Einwohner von Philippi	Noun, proper		
Filippus	Noun, proper		
ledern	Adjective		
filu	Unassigned		
Arglist	Noun, common, feminine		
sehr bunt	Adjective		
sehr wertvoll	Adjective		
Vielheit, Menge; Übermaß	Noun, common, feminine	2987	AMOUNT
vieles Reden	Noun, common, feminine		
viel Worte machen	<none>		
fünf	Numeral, cardinal	493	FIVE
fimftaihun	Numeral, cardinal		
fünfzehnter	Numeral, ordinal		
erkennen, erfahren	Verb	2870	RECOGNIZE (SOMEBODY)
Fischer	Noun, common, masculine	1858	FISHERMAN
fischen	Verb	2638	FISHING
Fisch	Noun, common, masculine	227	FISH
kreißen, gebären	Verb	1195	GIVE BIRTH
den Flechten	Noun, common		
umgetrieben	Verb		
prahlen	Verb	101	BOAST
von eitler Ruhmsucht, prahlerisch	Adjective		
Strom, Flut	Noun, common	666	RIVER
betrauern	Verb		
Nahrung	Noun, common, feminine	256	FOOD
nähren, aufziehn	Verb		
Scheide	Noun, common, neuter		
Feuer	Noun, common, neuter	221	FIRE
Fußfessel	Noun, common, feminine		
Fußbank, Schemel	Noun, common, neuter		
Fuß	Noun, common, masculine	1301	FOOT
Verkaufsurkunde	Noun, common, feminine		
fragen	Verb	1309	ASK (INQUIRE)
verlobt	Noun, common, feminine		
fragen	Verb	1309	ASK (INQUIRE)
erfragen	Verb		
versuchen	Verb	1812	TRY
versuchen	Verb	1812	TRY
Versuchung	Noun, common, feminine		
Same	Noun, common, neuter	714	SEED
Erlaß	Noun, common, neuter		
Freigelassener	Noun, common, masculine		
Verderben	Noun, common, feminine	92	SPOIL (SOMEBODY OR SOMETHING)
weiter	Adverb		
im Alter vorgeschritten	Adjective		
fremd; einer Sache	Adjective	109	FOREIGN
entfremden	Verb		
Fortschritt	Noun, common, feminine		
weiter	Adverb		
fernerhin	Adverb		
fortwährend	Adverb		
Verderb, Vergeudung	Noun, common, feminine		
Kindschaft	Noun, common, feminine		
Kind	Noun, common	2099	CHILD
klug machen	Verb		
Verstand, Sinn	Noun, common, neuter	2950	MEANING
Verstandestäuschung	Noun, common, feminine		
denken	Verb	1415	THINK (REFLECT)
bei  Verstand sein	Verb		
Herr	Noun, common, masculine	3153	LORD
Herrschaft	Noun, common, masculine		
herrschen über	Verb		
unterjochen	Verb		
Herrscher	Noun, common, masculine	3377	EMPEROR
Verderben	Noun, common, feminine	92	SPOIL (SOMEBODY OR SOMETHING)
sündig	Adjective		
Sünde	Noun, common, feminine	2971	SIN
Strafe	Noun, common, neuter		
einen schonen	Verb		
Freiheit	Noun, common, masculine		
frei von	Adjective		
zärtlich liebend	Adjective		
Liebe	Noun, common, feminine	923	LOVE
Freiheit	Noun, common, feminine		
lieben	Verb	923	LOVE
Freundin	Noun, common, feminine		
Freund	Noun, common, masculine	1325	FRIEND
Kuß	Noun, common, feminine		
abbilden	Verb		
ein Abbild werden	Verb		
Bild	Noun, common, feminine	3303	PICTURE (PAINTING)
Friedrich	Noun, proper		
versöhnen mit	Verb		
Frost	Noun, common	2034	FROST
Klugheit, Verstand	Noun, common, feminine	1562	MIND
klug, verständig	Adjective	1310	CLEVER
fruma	Adjective, Comparative		
Erstgeborener	Noun, common, masculine		
Vorrang	Noun, common, feminine		
Anfang	Noun, common, neuter	1557	BEGINNING
frumists	Adjective, Superlative		
zuerst	Adverb, temporal	2915	AT FIRST
Vogel	Noun, common, masculine	937	BIRD
Füllen	Noun, common, masculine	2006	FILL
verborgen	Adjective		
fulhsni	Noun, common, neuter		
P	<none>		
P	<none>		
vollkommen	Adjective		
vollkommen 	Adjective		
überreden	<none>		
volkommen 	Noun, common, masculine		
des Neumonds	Noun, common		
füllen	Verb	2006	FILL
mit etw	Verb		
überfüllen	Verb		
erfüllen, vollenden, ersetzen	Verb		
voll werden von	Verb		
erfüllt werden von	Verb		
erfüllt werden von	Verb		
Fülle, Füllung ; Flicken	Noun, common, feminine		
voll von	Adjective		
faul	Adjective	1564	LAZY
Feuer	<none>	221	FIRE
feurig	Adjective		
Fwgailus	Noun, proper		
phönikisch	Adjective		
Einschränkung	Noun, common, feminine		
Miterbe	Noun, common, masculine		
Gabaa	Noun, proper		
Gabair	Noun, proper		
Erscheinung	Noun, common, feminine		
Kollekte; Steuer	Noun, common, neuter		
Festgelage	Noun, common, masculine		
Mitbürger	Noun, common, masculine		
gern	Adverb		
Lust	Noun, common, masculine	2960	LONGING (WISH)
Geschlechtsregister	Noun, common, neuter		
Geburt	Noun, common, feminine	2805	BIRTH (ACCOUCHEMENT)
Reichtum	Noun, common, feminine	2996	WEALTH
reich an	<none>		
reich machen	Verb		
reich sein	Verb		
reich an	Adjective		
reichlich	Adverb, Comparative		
Band	Noun, common, feminine	2969	RIBBON
Band	Noun, common, feminine	2969	RIBBON
Erbarmen	Noun, common, feminine		
Gabriel	Noun, proper		
Brocken	Noun, common, feminine		
Band	Noun, common, feminine	2969	RIBBON
Teilnehmer, Genosse	Noun, common, masculine		
Hausgenosse	Noun, common, masculine		
Gaddarenus	Noun, proper		
Tat	Noun, common, feminine		
Gebilde	Noun, common, neuter		
Vetter	Noun, common, masculine		
es schickt sich für	Adjective		
Soldat	Noun, common, masculine	1941	SOLDIER
Fang	Noun, common, neuter		
Versammlung, hoher Rat	Noun, common, feminine		
ehrbar; nüchtern, besonnen	Adjective		
anständig	Adverb		
Kleidung	Noun, common, feminine	1895	CLOTHES
Begräbnis	Noun, common, neuter		
Klugheit, Besonnenheit	Noun, common, feminine		
Erhaltung, Bewahrung	Noun, common, feminine		
Kuß	Noun, common, feminine		
Versöhnung	Noun, common, feminine		
verborgen vor	Adjective		
Weg, Straße	Noun, common, neuter	2252	PATH
gehen	Verb	1443	WALK
weggehn von	Verb		
nachgehn, folgen	Verb	1085	FOLLOW
kommen	Verb	1446	COME
hinzugehen, kommen	Verb	1446	COME
hinzukommen zu	Verb		
hineinkommen	Verb		
vorübergehn	Verb		
einem vorausgehn	Verb		
vorangehn	Verb		
zusammenkommen	Verb		
hineingehn	Verb		
mitgehn mit	Verb		
hindurchgehn, vorübergehn	Verb		
etw übertreten	Verb		
ausgehn, hinausgehn	Verb	1107	GO OUT
hinausgehn, ausgehn	Verb	1107	GO OUT
entgegengehn	Verb	1778	APPROACH
Beschluß, Verordnung	Noun, common, feminine		
Frömmigkeit	Noun, common, feminine		
anständig, ehrbar	Adjective		
fromm	Adverb, Comparative		
im Zusammenhang, der Reihe nach	Adverb		
ganz unversehrt	Adjective		
Verheißung	Noun, common, neuter		
Gehör,  Predigt	Noun, common, feminine	2518	HEARING (AURAL SENSE)
Genosse	Noun, common, masculine		
Genosse	Adjective		
[ga-hnipnan]	Verb		
Enthaltsamkeit	Noun, common, feminine		
Reinigung	Noun, common, feminine		
Gesinnung; Sinn; Gewissen	Noun, common, feminine	2950	MEANING
fügsam, getreu	Adjective		
Verweilen, Ruhe	Noun, common, feminine	3458	SILENCE
gaiainna	Noun, common		
Mangel	Noun, common, neuter		
fröhlich machen	Verb		
Gainnesaraiþ	Noun, proper		
Gürtel	Noun, common, feminine	772	BELT
umgürten	Verb		
umgürten	Verb		
Gairgaisainus	Noun, proper		
Verlangen, Wunsch	Noun, common, feminine	2117	DESIRE
begehren, verlangen nach; bedürfen	Verb	2339	NEED (SOMETHING)
Leidenschaft	Noun, common, neuter		
erschrecken	Verb	252	FRIGHTEN
Böcklein	Noun, common, neuter		
Ziege	Noun, common, feminine	1502	GOAT
Gaïus	Noun, proper		
 Paar	Noun, common, neuter		
Genosse	Noun, common, masculine		
 Gleichnis	Noun, common, feminine		
Überredung	Noun, common, feminine		
gakunþs	Noun, common, feminine		
Probe	Noun, common, feminine		
Nachfolger	Noun, common, masculine		
Galateis	Noun, proper		
Galatia	Noun, proper		
gläubig	Adjective		
Glaube	Noun, common, feminine		
wertvoll	Adjective	3002	PRECIOUS
eines Leibes	Noun, common, masculine		
Abbild	Noun, common, neuter		
ähnlich	Adjective	1558	SIMILAR
gleich	Adverb, Comparative	2276	IDENTICAL
Galeilaia	Noun, proper		
Galeilaius	Noun, proper		
Pfahl, Kreuz	Noun, common, masculine	1367	CROSS
Beilager	Noun, common, neuter		
Lüge	Noun, common, neuter	2826	LIE (FALSEHOOD)
falscher Apostel	Noun, common, masculine		
falscher Bruder	Noun, common, masculine		
Götze	Noun, common, neuter		
falscher Prophet	Noun, common, masculine		
falscher Zeuge	Noun, common, masculine		
falscher Christus	Noun, common, masculine		
wertvoll	<none>	3002	PRECIOUS
Gemeinschaft	Noun, common, feminine		
Gemeinschaft	Noun, common, feminine		
Teilnehmer	Noun, common, masculine		
gemein	Adjective		
Versammlung	Noun, common, feminine		
verkrüppelt; verwundet	Adjective		
Auflösung	Noun, common, feminine		
Teilnehmer; Genosse	Noun, common, neuter		
gamarko	<none>		
Ärgernis	Noun, common, feminine		
Erinnerung	Noun, common, feminine		
Schrift; Buchstabenschrift	Noun, common, feminine		
Gedächtnis, Erinnerung	Noun, common, neuter	1018	MEMORY
Gedanke	Noun, common, feminine	2975	THOUGHT
Andenken, Gedächtnis	Noun, common, feminine	1018	MEMORY
Genüge, genügendes Auskommen; Genügsamkeit	Noun, common, masculine		
Rettung, Heil	Noun, common, feminine		
Verwandter	Noun, common, masculine		
genug, viel	Adjective	1198	MANY
verursachen	Verb		
übereinstimmend	Adjective		
Verabredung	Noun, common, feminine		
Zusammenkunft, Versammlung; Vereinigung	Noun, common, feminine		
Anordnung, Satzung, Regel	Noun, common, feminine		
Gerechtigkeit, Gebot	Noun, common, feminine		
Zurechtweisung	Noun, common, feminine		
Gerechtigkeit	Noun, common, feminine		
gerecht	Adjective		
angeordnet	Adjective		
Nachbar	Noun, common, masculine	1332	NEIGHBOUR
Nachbarin	Noun, common, feminine		
 Viehhof	Noun, common, masculine		
Hausherr	Noun, common, masculine		
Haus, Hauswesen, Familie	Noun, common, masculine	1252	HOUSE
anständig	Adverb		
bestimmte Zeit	Noun, common, feminine		
Schamhaftigkeit	Noun, common, feminine		
Ehrbarkeit	Noun, common, neuter		
ehrbar	Adjective		
Beratung	Noun, common, neuter		
Flut	Noun, common, feminine		
Markt; Straße	Noun, common, feminine	633	MARKET
Vorwurf	Noun, common, feminine		
Grundlegung	Noun, common, feminine		
Gefährte	Noun, common, masculine		
Gefährte	Noun, common, masculine		
Bedeckung	Noun, common, feminine		
Erschaffung	Noun, common, feminine		
Unterschied	Noun, common, feminine		
Mitknecht	Noun, common, neuter		
Sandalen, Schuhe	Noun, common, neuter		
beschuht	Adjective		
Gastfreundschaft	Noun, common, feminine		
gastfrei	Adjective		
Fremdling 	Noun, common, masculine		
Riß	Noun, common, masculine		
Zerstörung	Noun, common, feminine		
geziemend	Adverb		
passend; geschickt zu	Adjective		
zur rechten Zeit, passend	Adverb, Comparative		
Erbauung	Noun, common, feminine		
Gebäude	Noun, common, feminine	3396	BUILDING
Gasse	Noun, common, feminine		
Bedacht	Noun, common, neuter		
enthaltsam	Adjective		
Trost	Noun, common, feminine		
Trost	Noun, common, feminine		
Tenne, Ausdrusch	Noun, common, neuter		
Umgegend	Noun, common, masculine		
Gaulgauþa	Noun, proper		
Gaumaurra	Noun, proper		
Gaumaurjam	Noun, proper		
bemerken	Verb	2893	NOTICE (SOMETHING)
klagen; Totenklage anstimmen	Verb		
Klage	Noun, common, masculine		
Betrübnis	Noun, common, feminine		
Betrübnis	Noun, common, feminine		
einen kränken	Verb		
betrübt, traurig	Adjective	699	SAD
friedfertig	Adjective		
Friede	Noun, common, neuter	1338	PEACE
Erwählung	Noun, common, feminine		
gemein di unrein	Adjective		
Bekehrung	Noun, common, feminine		
Verurteilung	Noun, common, feminine		
Bekleidung	Noun, common, feminine		
Gespräch	Noun, common, neuter	2933	CONVERSATION
Geschäft; Erwerb; Gewinn	Noun, common, neuter	2931	BUSINESS
Mitarbeiter	Noun, common, masculine		
eingewurzelt	Adjective		
Gau	Noun, common, neuter		
einmütig	Adjective		
Verbindung, Band 	Noun, common, feminine	2969	RIBBON
voll Mitfreude	Adjective		
Schatzhaus	Noun, common		
Stachel	Noun, common, masculine	3798	STINGER
begehren	Verb		
gewinnen	Verb		
sich entsetzen, erstaunen	Verb		
Gabe, Geschenk	Noun, common, feminine	2982	GIFT
geben	Verb	1447	GIVE
Geber	Noun, common, masculine		
sich wegbegeben	Verb		
hingeben, übergeben	Verb		
vergeben, verleihn, schenken	Verb	196	DONATE
erstatten, bezahlen	Verb	718	PAY
Giebel	Noun, common, masculine		
Steuer	Noun, common, neuter		
vergelten	Verb		
vergelten	Verb		
Steuer	Noun, common, neuter		
Eintragung in die Steuerliste	Noun, common, feminine		
Sichel	Noun, common, feminine	341	SICKLE
beginnen	Verb		
morgen	Adverb, temporal	1329	TOMORROW
finden	Verb	719	FIND
gießen	Verb	3078	IRRIGATE
übergießen di übervoll gießen	Verb		
sorgsam	Adverb		
genau	Adverb	1466	EXACT
genau	Adverb	1466	EXACT
glänzen	Verb		
von guter, edler Abkunft	Adjective		
Tugend	Noun, common, feminine		
Gruß	Noun, common, feminine		
grüßen	Verb		
gut	Adjective	1035	GOOD
Graben	Noun, common, feminine	1418	DIG
graben	Verb	1418	DIG
mit einem Graben umgeben	Verb		
nachgraben, unterwühlen	Verb		
ausgraben	Verb		
erzürnen	Verb		
erbittern	Verb		
Holzsplitter	Noun, common		
Gras, Kraut	Noun, common, neuter	606	GRASS
hungrig	Adjective	1533	BE HUNGRY
hungern	Verb	1533	BE HUNGRY
Hunger	Noun, common, masculine	1864	HUNGER
greifen	Verb	855	SEIZE
ergreifen	Verb	855	SEIZE
ergreifen	Verb	855	SEIZE
weinen, klagen	Verb	1839	CRY
das Weinen	Noun, common, masculine	1839	CRY
kleinmütig	Adjective		
Schritt	Noun, common, feminine		
Grube, Höhle	Noun, common, feminine	1155	CAVE
Grundmauer	Noun, common, masculine		
gottesfürchtig	Adjective		
gottlos	Adjective		
Gottesgestalt	Noun, common, feminine		
Gottesverehrer	Noun, common, masculine		
Gotteshaus	Noun, common, neuter		
Gudilub	Noun, proper		
göttlich	Adjective		
Priester	Noun, common, masculine	852	PRIEST
Priestertum	Noun, common, masculine		
Priester sein, des Priesteramts pflegen	Verb		
Gold	Noun, common, neuter	1369	GOLD
golden	Adjective		
Mann	Noun, common, masculine	1554	MAN
männlichen Geschlechts	Adjective		
Männchen	Noun, common, neuter		
Krebsgeschwür	Noun, common, neuter		
verschüttet werden	Verb		
Gotenvolk	Noun, common, feminine		
Gott	Noun, common, masculine	1944	GOD
haben, besitzen	Verb	684	OWN
sich einer Sache enthalten	Verb		
besitzen	Verb	684	OWN
sich nähern	Verb	1778	APPROACH
ergreifen	Verb	855	SEIZE
ergreifen	Verb	855	SEIZE
aufheben	Verb	371	PICK UP
heben	Verb	501	LIFT
erwidern, antworten	Verb	1275	ANSWER
herabnehmen	Verb		
sich überheben	Verb		
erheben, wegnehmen	Verb		
sich überheben	Verb		
sich heften, hängen an	Verb		
sich heften, hängen an	Verb		
zusammenheften, verbinden	Verb	2862	CONNECT
anhangen	Verb		
behaftet mit	Adjective		
hängen, in der Schwebe lassen	Verb	2884	HANG
hinabhängen, hinablassen	Verb		
sich erhängen	Verb		
hangen	Verb		
Haibraius	Noun, proper		
Art u Weise	Noun, common, masculine		
streiten	Verb	3302	QUARREL (VERB)
Streit	Noun, common, feminine		
einäugig	Adjective		
Haileias	<none>		
Haileisaius	Noun, proper		
einen  heilen	Verb		
herstellen	Verb	2886	PRODUCE
hergestellt werden	Verb		
heil, gesund	Adjective	1364	HEALTHY
Grundbesitz	Noun, common, neuter		
Stadt	Noun, common, feminine	1391	TOWN
Parteien	Noun, common		
Herde	Noun, common, feminine	2939	FLOCK (OF ANIMALS)
Hirt	Noun, common, masculine	2544	SHEPHERD
Hairmaugaineis	Noun, proper		
Hairodia	<none>		
Herz	Noun, common, neuter	1223	HEART
Eingeweide, Herz	Noun, common	1223	HEART
Schwert	Noun, common, masculine		
Fakkeln	Noun, common		
heißen, nennen	Verb	180	CALL BY NAME
anrufen	Verb		
einen, etw bekennen; sich bekennen zu; etw bekennen	Verb		
herzurufen	Verb		
verheißen	Verb		
zusammenrufen	Verb		
zuvor verheißen	Verb		
herausfordern	Verb		
Geheiß	Noun, common, feminine		
Heide, Steppe	Noun, common, feminine		
wild	Adjective	2230	UNTAMED OR WILD
Heidin	Noun, common, feminine		
Mantel	Noun, common, masculine	603	COAT
Hälfte, Seite	Noun, common, feminine	816	HALF
halb	Adjective	3836	HALF (HALF OF)
hüten, weiden	Verb	2885	HERD (SOMETHING)
mehr	Adverb	1992	MORE
kaum je, kaum	Adverb	2926	HARDLY
Hölle	Noun, common, feminine		
leer, umsonst; dürftig, armselig	Adjective	1624	EMPTY
Fels	Noun, common, masculine	668	ROCK
Hals	Noun, common, masculine	1333	NECK
Hals, Nacken	Noun, common, masculine	1333	NECK
lahm	Adjective	320	LAME
verstümmelt	Adjective		
die Bekleidung ablegen, ausziehn	Verb		
die Bekleidung anlegen, anziehn	Verb		
sich einer Sache entkleiden	Verb		
sich bekleiden mit	Verb		
überziehn, sich mit etwas überkleiden	Verb		
Hahn	Noun, common, masculine	1511	ROOSTER
Weisheit	Noun, common, feminine		
weise, klug	Adjective	1310	CLEVER
Hand	Noun, common, feminine	1277	HAND
mit der Hand gemacht	Adjective		
Schar; Manipel; Kohorte	Noun, common, feminine		
verhärten	Verb		
Hartherzigkeit	Noun, common, feminine		
hart, streng	Adjective	1884	HARD
Heer	Noun, common, masculine		
hassen	Verb	1607	HATE
Haß, Zorn	Noun, common, neuter		
zürnen	Verb	2223	BE ANGRY
hassen	Verb	1607	HATE
Haupt	Noun, common, neuter		
Höhe	Noun, common, feminine	2985	HEIGHT
Preis, Ehre	Noun, common, feminine	657	PRICE
Hochmut	Noun, common, feminine		
hochmütig	Adjective		
höchste Höhe	Noun, common, neuter		
Höhe	Noun, common, feminine	2985	HEIGHT
hoch machen; preisen	Verb		
verblenden	Verb		
erhöhn	Verb		
verherrlicht werden	Verb		
hoch	Adjective	1265	HIGH
der Höchste 	Adjective, Superlative		
hauhaba	Adverb		
höher	Adverb, Comparative		
hochmütig, verblendet	Adjective		
Erniedrigung; Demut	Noun, common, feminine		
Demut	Noun, common, feminine		
niedrig machen	Verb		
erniedrigen	Verb		
niedrig, demütig	Adjective	3348	LOW (POSITION OR HEIGHT)
 Tür	Noun, common, feminine	1567	DOOR
Kohle	Noun, common, neuter	2658	COAL
das hornförmig gebogene Johannisbrot	Noun, common, neuter		
Hornist	Noun, common, masculine		
das Horn blasen	Verb		
Gehör di Ohr	Noun, common, feminine		
hören	Verb	1408	HEAR
gehorchen	Verb	1635	OBEY
das Gehör bekommen	Verb		
gehorchen	Verb	1635	OBEY
hören	Verb	1408	HEAR
Heu	Noun, common, neuter	342	HAY
Lob, Loblied	Noun, common, feminine		
loben, preisen wegen	Verb	3455	COMMEND
Fieber	Noun, common, feminine	1534	FEVER
Hausherr	Noun, common, masculine		
helei	Foreign word		
Helei	Noun, proper		
Helias	Noun, proper		
Her	Noun, proper	2925	HITHER (HERE TO)
hier, her	Adverb, locative	136	HERE
Herodes	Noun, proper		
Herodia	Noun, proper		
Herodianus	Noun, proper		
Kammer	Noun, common, feminine		
dieser	Pronoun, demonstrative	1214	THIS
hierher	Adverb, directional		
Helm	Noun, common, masculine	1680	HELMET
einem helfen	Verb		
helfen	Verb	1897	HELP
von himmlischer Abkunft	Adjective		
Himmel	Noun, common, masculine	1732	SKY
dieser	<none>	1214	THIS
hinter, jenseits	Unassigned	1686	BEHIND
hinter, jenseits	Preposition, +AD	1686	BEHIND
hinterlistig	Adjective		
Hinterlist	Noun, common, feminine		
der hinterste	Adjective, Superlative		
gefangen nehmen	Verb		
mitgefangen nehmen	Verb		
erbeuten	Verb		
komm her, hierher	Unassigned		
dieser	<none>	1214	THIS
wehklagen, Klagelieder singen	Verb		
Haufe, Menge	Noun, common, masculine	2987	AMOUNT
Gestalt, Aussehn	Noun, common, neuter		
lachen	Verb	1355	LAUGH
verlachen	Verb		
Brot; Brotbissen	Noun, common, masculine	1368	BREAD
Hügel	Noun, common	614	HILL
Grab	Noun, common, neuter	1773	GRAVE
Gräber	Noun, common, feminine		
Schlinge	Noun, common, feminine	2604	NOOSE
heiter	Adjective	1495	HAPPY
sorgenfreier	Adjective, Comparative		
Heiterkeit	Noun, common, feminine		
beladen	Verb		
aufspringen, sich aufmachen	Verb		
Los; Anteil, Erbschaft	Noun, common, masculine		
sich annehmen	Verb		
link	Adjective, Comparative		
Zelt, Hütte	Noun, common, feminine	1316	TENT
ein Zelt über mir aufschlage	Verb		
das Zeltaufschlagen, Laubhüttenfest	Noun, common, feminine		
stehlen	Verb	713	STEAL
Dieb	Noun, common, masculine	1160	THIEF
Hütten, Zelte	Noun, common		
Gehör	Noun, common, masculine	2518	HEARING (AURAL SENSE)
auflachen machen	Verb		
Lauterkeit	Noun, common, feminine		
Lauterkeit	Noun, common, feminine		
lauter, rein	Adjective	704	CLEAN
Erniedrigung, Demut	Noun, common, feminine		
niedrig machen	Verb		
niederlegen	Verb		
erniedrigen	Verb		
einen unterwerfen unter 	Verb		
niedrig, demütig	Adjective	3348	LOW (POSITION OR HEIGHT)
weich, weichlich	Adjective	1856	SOFT
sich neigen	Verb		
sich niederbeugen	Verb		
sich betrüben	Verb		
zerreißen	Verb	1735	TEAR (SHRED)
zerreißen	Verb	1735	TEAR (SHRED)
spitzer Pfahl	Noun, common, feminine		
Pflug	Noun, common, masculine	2154	PLOUGH (INSTRUMENT)
durch Betrug schädigen, schikanieren	Verb		
übervorteilen	Verb		
Ehebruch; Hurerei	Noun, common, masculine	902	ADULTERY
huren, Ehebruch treiben	Verb		
Ehebruch begehn	Verb		
Hurer, Ehebrecher	Noun, common, masculine		
Reinheit, wohl auch Reinigung	Noun, common, feminine		
Reinigung	Noun, common, feminine		
reinen Herzens	Adjective		
reinigen	Verb	2235	CLEAN (SOMETHING)
etwas Verunreinigendes tilgen	Verb		
reinigen	Verb	2235	CLEAN (SOMETHING)
ausfegen	Verb		
rein, ehrbar	Adjective	704	CLEAN
Turteltaube	Noun, common, feminine		
kreuzigen	Verb		
kreuzigen	Verb		
abschütteln	Verb		
abschütteln	Verb		
rufen	Verb	1084	CALL
aufschreien, ausrufen	Verb		
Ruf, Geschrei	Noun, common, masculine	2944	CALL (APPEAL)
Dach, Haus	Noun, common, neuter	1252	HOUSE
siegreich	Adjective		
Stab	Noun, common, feminine		
krähen	Verb		
das Krähen	Noun, common		
nachforschen	Verb	2010	INVESTIGATE
hungern	Verb	1533	BE HUNGRY
denken, meinen	Verb	1415	THINK (REFLECT)
bezaubern	Verb		
and-hugjan	Verb		
sich vornehmen	Verb		
sich überheben	Verb		
Verstand	Noun, common, masculine	1562	MIND
Landgut, Feld	Noun, common, neuter	212	FIELD
häufen, sammeln	Verb	7	GATHER
Hunger, Hungersnot	Noun, common, masculine	1864	HUNGER
Hülle	Noun, common, neuter		
hüllen, verhüllen	Verb		
enthüllen	Verb		
verhüllen	Verb		
verhüllen	Verb		
aushöhlen	Verb	46	HOLLOW OUT
hold	Adjective		
Höhle	Noun, common, feminine	1155	CAVE
-hun	Particle, enclitic		
Hunderte	Numeral, cardinal		
Centurio	Noun, common, masculine		
Hund	Noun, common, masculine	2009	DOG
Opfer	Noun, common, neuter	1103	SACRIFICE
Opferstätte, Altar	Noun, common, masculine		
opfern	Verb		
Fang, Beute	Noun, common, masculine		
Hüfte	Noun, common, masculine	1745	HIP
Hort, Schatz	Noun, common, neuter		
Schätze sammeln	Verb		
Hwmainaius	Noun, proper		
hwssopon	Noun, common		
wohin	<none>	2928	WHITHER (WHERE TO)
wohin	Adverb, directional	2928	WHITHER (WHERE TO)
jeder	<none>		
wandeln	Verb		
umdrängen	Verb		
Schädel	Noun, common, feminine	1605	SKULL
Weizen	Noun, common, masculine		
wie	Adverb	1239	HOW
wann	Adverb	1238	WHEN
jemals	Adverb		
ersticken, auslöschen	Verb	127	EXTINGUISH
ersticken, erlöschen	Verb	129	CHOKE
wo	Adverb	1237	WHERE
wandeln	Verb		
wer	Pronoun, interrogative	1235	WHO
jeder	Pronoun, indefinite		
wer	Pronoun, interrogative	1235	WHO
jemand	Pronoun, indefinite	2422	SOMEONE
scharf, streng	Adverb, manner	1396	SHARP
Schärfe, Strenge	Noun, common, feminine		
[gaƕatjan]	Verb		
wohin	Adverb, directional	2928	WHITHER (WHERE TO)
wer von beiden	Pronoun, interrogative		
jeder von beiden	Pronoun, indefinite		
schäumen	Verb		
Schaum	Noun, common, feminine	1768	FOAM
woher	Adverb, directional		
jeder	Pronoun, indefinite		
wem, mit wem, womit	Adverb	1236	WHAT
jedenfalls, nur	Unassigned	1580	ONLY
Weile, Zeit, Stunde	Noun, common, feminine	892	TIME
nur eine Zeitlang dauernd, vergänglich	Adjective		
aufhören	Verb	1928	CEASE
beruhigen, erquicken	Verb		
zur Ruhe kommen, aufhören	Verb	1928	CEASE
nicht eine Stunde lang	Unassigned		
weißen	Verb		
weiß	Adjective	1335	WHITE
wie groß	Adjective		
wie beschaffen	Adjective		
Totenkiste, Sarg	Noun, common, feminine		
Das Rühmen, der Ruhm	Noun, common, feminine		
jeder	<none>		
sich einer Sache rühmen	Verb		
Drohung	Noun, common, feminine		
drohen	Verb	1192	THREATEN
einen bedrohn	Verb		
Iaeirus	Noun, proper		
Iairaimias	Noun, proper		
P	Noun, proper		
Iericho	Noun, proper		
Iairusalem	Noun, proper		
Iairusaulwma	Noun, proper		
Iairusaulwmeis	Noun, common		
Iairusaulwmeite	Noun, proper		
Iaissaizis	Noun, proper		
Iakob	Noun, proper		
Iakobus	Noun, proper		
Iaredis	Noun, proper		
Iareim	Noun, proper		
Iasson	Noun, proper		
Iaurdanus	Noun, proper		
doch nicht	Particle		
Berglehne	Noun, common		
gleich	Adjective	2276	IDENTICAL
gleichen Körpers	Adjective		
gleichschön	Adjective		
skauneis	Adjective		
Gleichheit	Noun, common, masculine		
gleich machen	Verb		
eben, flach	Adjective	1633	FLAT
rückwärts gewandt	Adjective		
iddja	<none>		
Buße	Noun, common, feminine		
Reue empfinden	Verb		
bereuen, Buße tun	Verb		
Idumaia	Noun, proper		
Schmach, Schimpf	Noun, common, neuter		
schmähn	<none>		
Iesus	Noun, proper		
am folgenden Tage	Adjective, Comparative		
euch beiden gehörig	Pronoun, possesive		
igqis	Pronoun, personal		
ich	Pronoun, personal	1209	I
der ich	Pronoun, personal, relative	1209	I
in, auf, an, unter	Preposition, +ADG	1485	BELOW OR UNDER
Besonnenheit, Selbstbeherrschung	Noun, common, feminine		
verständig	Adjective		
Hausgenosse	Noun, common, masculine		
Entschuldigung	Noun, common, feminine		
schwanger	Noun, common, feminine	1123	PREGNANT
Stammesgenosse, Landsmann	Noun, common, masculine		
Vertauschung	Noun, common, feminine		
hinein	Adverb, directional		
innen, innerhalb	Adverb, locative		
zum Hause gehörig, Hausgenosse	Adjective		
von innen	Adverb, directional		
Eingang, Eintritt	Noun, common, feminine		
von innen	Adverb, directional		
Erneuerung	Noun, common, feminine		
der innere	Adjective, Comparative		
Erzählung, Aussage, Zeugnis	Noun, common, feminine	2060	STORY
ohne, außer	Preposition, +A	1478	WITHOUT
in, auf, an, unter	<none>	1485	BELOW OR UNDER
Ungerechtigkeit	Noun, common, feminine		
ungerecht	Adjective		
innerhalb des Gesetzes stehend	Adjective		
Ioanan	Noun, proper		
Ioda	Noun, proper		
Iohanna	Noun, proper		
Iohanna	Noun, proper		
Iohannes	Noun, proper		
Iora	Noun, proper		
Ioreim	Noun, proper		
Iosef	Noun, proper		
Iosezis	Noun, proper		
er, der	Pronoun, personal	1211	HE
Isak	Noun, proper		
Iskariotes	Noun, proper		
Israel	Noun, proper		
Israeleites	Noun, proper		
essen	Verb	1336	EAT
etw verzehren, fressen	Verb		
Ituraia	Noun, proper		
aber	Conjunction	3843	BUT
Iudaia	Noun, proper		
Iudaialand	Noun, common, neuter		
Iudaius	Noun, proper		
Judaius	<none>		
auf jüdische Weise	Adverb		
jüdisch leben	Verb		
Iudas	Noun, proper		
Haufe	Noun, common, feminine		
aufwärts	Adverb, directional	1591	UP
oben	Adverb, locative	1265	HIGH
von oben	Adverb		
von oben her	Adverb, directional		
Iuse	<none>		
Erholung	Noun, common, feminine		
vorzüglicher	Adjective, Comparative		
izei	Unassigned		
ize	<none>		
euer	Pronoun, possesive	2274	YOUR (PLURAL)
der du	Pronoun, personal, relative	1215	THOU
ja	Unassigned	1268	YES
ob	Unassigned		
Jaeirus	<none>		
und, und zwar, auch	Unassigned	1577	AND
ja, wahrlich, fürwahr	Unassigned	1268	YES
an jenem Ort, dort	Adverb, locative	1937	THERE
dorthin	Adverb, directional	2923	THITHER (THERE TO)
dorthin	Adverb, directional	2923	THITHER (THERE TO)
dorthin gewandt	Adjective		
jener	Pronoun, demonstrative	78	THAT
dorther	Adverb, directional		
P	Noun, proper		
Janna	Noun, proper		
Jannes	Noun, proper		
und wenn	Conjunction		
ob	Unassigned		
Jaurdanau	<none>		
Jahr	Noun, common, neuter	1226	YEAR
Zornausbrüche; Streitereien	Noun, common, feminine		
kämpfen; obsiegen	Verb	1423	FIGHT
besiegen	Verb	782	DEFEAT
Julmonat	Unassigned		
jota	Noun, common, masculine		
schon	Adverb, temporal	2576	ALREADY
jüdisch	Adjective		
Judaius	<none>		
Judas	<none>		
jung; jugendlich	Adjective	1207	YOUNG
Gespann	Noun, common, neuter		
Joch	Noun, common, feminine	14	YOKE
Jugend	Noun, common, feminine		
ihr	Pronoun, personal	1213	YOU
Justus	Noun, proper		
schon	Adverb	2576	ALREADY
jūzei	Pronoun, personal, relative		
Kaballarja	Noun, proper		
Kaeinan	Noun, proper		
Kafarnaum	Noun, proper		
Kaidmeiel	Noun, proper		
Kaidron	Noun, proper		
Kaiser	Noun, common, masculine		
Census, Steuer	Noun, common, neuter		
Kaisaria	Noun, proper		
Kajafa	Noun, proper		
Kalbe 	Noun, common, feminine		
kalt	Adjective	1287	COLD
Hurerei	Noun, common, masculine		
Hure	Noun, common, feminine	1610	PROSTITUTE
Kananeites	Noun, proper		
kennen, wissen	<none>	1410	KNOW (SOMETHING)
einem  kund tun	Verb		
verkünden	Verb		
verkünden	Verb		
das Haar abschneiden	Verb		
Sorge	Noun, common, feminine	1668	GRIEF
[Kareiaþiareim]	Noun, proper		
Kerker	Noun, common, feminine		
sich kümmern	Verb		
besorgen	Verb		
Karpus	Noun, proper		
Gefäß	Noun, common, neuter		
Töpfer	Noun, common, masculine		
Kessel	Noun, common, masculine	854	KETTLE
den Kolossern	Noun, proper		
ohrfeigen	Verb		
Geschäfte machen, Handel treiben	Verb	2135	TRADE OR BARTER
Kaurazein	Noun, proper		
Gabe, fromme Stiftung	Foreign word		
Tempelschatz	Noun, common		
Schwere, Fülle	Noun, common, feminine		
Kaurinþius	Noun, proper		
Kaurinþon	Noun, proper		
Last	Noun, common, feminine	1679	LOAD
drücken, belästigen	Verb	1913	PRESS
beschweren	Verb		
mitbelastet mit	Verb		
schwer, lästig	Adjective	1210	HEAVY
Getreide	Noun, common, neuter	605	GRAIN
Korn	Noun, common, neuter	605	GRAIN
kosten, kennen lernen	Verb	21	TASTE (SOMETHING)
erproben	Verb		
kawtsjo	Foreign word		
Kefas	Noun, proper		
keimen	Verb		
hervorkeimen	Verb		
mithervorkeimen	Verb		
Turm; Speisesaal im Obergeschoss	Noun, common, neuter		
Kileikia	Noun, proper		
Mutterleib	Noun, common, feminine		
Statthalter	Noun, common, masculine		
Wange	Noun, common, feminine	1730	CHEEK
Heller	Noun, common, masculine		
etwas  prüfen	Verb		
erproben	Verb		
erproben	Verb		
Klemaintau	Noun, proper		
Klaimaintau	<none>		
gellen	Verb		
Becken	Noun, common, feminine		
Knie	Noun, common, neuter	1371	KNEE
Geschlecht	Noun, common, feminine		
niederfallen	Verb		
Kosam	Noun, proper		
Grieche 	Noun, common, masculine		
[Kreskus]	Noun, proper		
Kretai	Noun, proper		
Kretes	Noun, proper		
Krispus	Noun, proper		
knirschen	Verb		
zerbrechen, zerschellen	Verb	2558	BREAK (CLEAVE)
Knirschen	Noun, common		
Tischgesellschaft, Gruppe	Noun, common, masculine		
einen küssen	Verb		
mit Küssen bedecken	Verb		
sich niederlegen, zu Tische legen	Verb	215	LIE DOWN
kumei	Foreign word		
Fessel	Noun, common, feminine		
Geschlecht, Stamm	Noun, common, neuter	344	TREE TRUNK
kennen, wissen	Verb	1410	KNOW (SOMETHING)
verachten	Verb	2715	DESPISE
sich unterordnen, gehorchen	Verb	1635	OBEY
-kunnan	Verb		
etw lesen	Verb		
gewähren	Verb		
kennen lernen, erfahren	Verb	2218	EXPERIENCED
erkennen	Verb	2870	RECOGNIZE (SOMEBODY)
Kunde, Kenntnis	Noun, common, neuter		
kund, bekannt	Adjective	3005	FAMILIAR
Kusa	Noun, proper		
Kustanteinus	Noun, proper		
Prüfung	Noun, common, masculine		
Quirinius	Noun, proper		
Einwohner von Kyrene	Noun, proper		
Langmut	Noun, common, feminine		
Länge	Noun, common, feminine	2537	LENGTH
lang	Adjective	1203	LONG
legen, auflegen, hinlegen	Verb	2071	LAY (VERB)
etwas ablegen	Verb		
einem  auflegen	Verb		
hinlegen, auflegen	Verb	998	PUT
einem  etw vorlegen	Verb		
hinlegen	Verb	998	PUT
überdecken	Verb		
us-lagjan	Verb		
schmähn	Verb		
lauan	<none>		
Überbleibsel	Noun, common, feminine		
übrig lassen	Verb		
bleiben	<none>	987	REMAIN
Legion	Foreign word		
etw belecken	Verb		
hüpfen, springen	Verb	1829	JUMP
einen  verspotten	Verb		
Tanz	Noun, common, masculine		
Leseabschnitt	Foreign word		
 weiß	Verb	1335	WHITE
Lehrer	Noun, common, masculine	1038	TEACHER
zum Lehren befähigt	Adjective		
Lehre	Noun, common, feminine		
lehren	Verb	709	TEACH
lehren	Verb	709	TEACH
belehren	Verb		
einem folgen, nachstreben	Verb		
einem nachfolgen, nachstreben; nachgehn 	Verb		
Gastfreundschaft pflegend	Verb		
Spur	Noun, common, masculine	318	FOOTPRINT
Laiwweis	Noun, proper		
Laiwweiteis	Noun, common		
Lamaik	Noun, proper		
Lamm, Schaf	Noun, common, neuter	1331	SHEEP
Land; Gegend	Noun, common, neuter	1300	COUNTRY
schwach	Adjective	1601	WEAK
Lässigkeit	Noun, common, feminine		
aufhalten	Verb		
verhindern; ihr bekommt keine Gelegenheit	Verb	1550	PREVENT
verhindern	Verb	1550	PREVENT
lässig, faul	Adjective	1564	LAZY
gern	Adverb		
laden	Verb	3669	LOAD (SOMETHING)
berufen	Verb		
zusammenberufen, einladen	Verb	1611	INVITE
Einladung, Berufung	Noun, common, feminine		
schmähn	<none>		
glauben	Verb	1890	BELIEVE
einem erlauben	Verb		
Laudeikaia	Noun, proper		
Gestalt	Noun, common, feminine		
Laub, Blatt	Noun, common, masculine	628	LEAF
leugnen	Verb	755	DENY
verborgen bleiben	Verb		
blitzen	Verb		
Blitz	Noun, common, feminine	1654	LIGHTNING
Lauidjai	Noun, proper		
Lohn	Noun, common, neuter	1122	WAGES
undankbar	Adjective		
los, leer	Adjective	1624	EMPTY
leeres Gerede	Noun, common, feminine		
leeres Gerede	Noun, common, neuter		
hohle Schwätzer	Adjective		
mit leeren Händen	Adjective		
lösen	Verb	352	UNTIE
erlösen, befreien	Verb		
entwurzele dich	Verb		
Fasten	Noun, common, feminine	303	ABSTAIN FROM FOOD
leeren Magens, nüchtern	Adjective		
Lazarus	Noun, proper		
bleiben	Verb	987	REMAIN
leicht	Adjective	1052	LIGHT (WEIGHT)
leihen; sich borgen von	Verb	582	LEND
Körper, Leib	Noun, common, neuter	1480	BODY
Gefallen	Noun, common, feminine		
einem gefallen, zu Gefallen sein	Verb		
gefallen	Verb		
vorhergefallen	Verb		
leiblich, fleischlich	Adjective		
Arzt	<none>	597	PHYSICIAN
anstaunen, bewundern	<none>		
meine Nachahmer	Verb		
sich verwandeln, eine Gestalt annehmen	Verb		
verwandeln	Verb		
mitnachahmen	Verb		
þairh-gáleikon	Verb		
Leinwand	Noun, common, neuter		
lassen	<none>	2896	CAUSE TO (LET)
klein, wenig	Adjective	1246	SMALL
weggehn, entweichen, verreisen	Verb	1752	LEAVE
verlassen, zurücklassen	Verb	1752	LEAVE
kommen, gehn	Verb	1446	COME
hineingehn	Verb		
mithineingehn	Verb		
hinzukommen	Verb		
hindurchgehn	Verb		
übersetzen	Verb	2906	TRANSLATE
hinausgehn, weggehn; verreisen	Verb	1752	LEAVE
Obstwein	Noun, common		
Arzt	Noun, common, masculine	597	PHYSICIAN
Heilung	Noun, common, masculine		
heilen	Verb	499	CURE
herstellen	Verb	2886	PRODUCE
lassen	Verb	2896	CAUSE TO (LET)
entlassen	Verb	1095	LET GO OR SET FREE
lassen; frei lassen, entlassen; unterlassen; zulassen, erlauben; erlassen, vergeben; herablassen	Verb	2896	CAUSE TO (LET)
ausschließen	Verb		
scheiden	Verb		
Gelegenheit, Veranlassung	Noun, common		
verraten	Verb	1902	BETRAY
verraten	Verb	1902	BETRAY
hingeben, überlassen	Verb		
Leben	Noun, common, feminine	210	LIFE
leben	Verb	1422	BE ALIVE
mitleben	Verb		
übrig bleiben	Verb		
liegen	Verb	1411	LIE (REST)
steht in meiner Macht	Verb		
unterliegen	Verb		
Lager, Bett	Noun, common, masculine	1663	BED
lima	Foreign word		
weggehn	Verb	1752	LEAVE
lesen, sammeln	Verb	724	READ
zusammenlesen, versammeln	Verb		
listig	Adjective		
List	Noun, common		
Heuchelei	Noun, common, feminine		
Bittgebet	Noun, common, feminine		
heucheln mit	Verb		
Glied	Noun, common, masculine	1222	PENIS
lieblich	Adjective		
wachsen	Verb	479	GROW
einem  danken	<none>		
lieb	Adjective	2470	DEAR
Heirat, Ehe	Noun, common, feminine	2432	MARRIAGE
heiraten	Verb	203	MARRY
ein Weib nehmen	Verb		
lügen	Verb	601	LIE (MISLEAD)
Lüge	Noun, common	2826	LIE (FALSEHOOD)
Lügenprophet	Noun, common, masculine		
Lügen redend	Adjective		
Lügner	Noun, common, masculine	3470	LIAR
liuhadei	Noun, common, feminine		
Helle, Glanz	Noun, common, feminine		
hell	Adjective	679	BRIGHT
Licht	Noun, common, neuter	630	LIGHT (RADIATION)
leuchten	Verb		
etw erleuchten, ans Licht bringen	Verb		
erleuchten	Verb		
etwas verlieren	Verb		
Heuchelei	Noun, common, feminine		
Gaukler	Adjective		
Sänger	Noun, common, masculine		
einem lobsingen	Verb		
flache Hand	Noun, common, masculine		
Loþ	Noun, proper		
Hoffnung	Noun, common, feminine		
giftkundig	Adjective		
Giftmischerei, Zauberei	Noun, common, feminine		
Angesicht	Noun, common, feminine		
Luft	Noun, common	27	AIR
verschließen	Verb		
erschließen, öffnen	Verb	1156	OPEN
Leuchte, Licht	Noun, common, neuter	630	LIGHT (RADIATION)
Leuchter	Noun, common, masculine		
Lukas	Noun, proper		
Lukius	Noun, proper		
sich verschließen	Verb		
sich erschließen, öffnen	Verb	1156	OPEN
Lösegeld	Noun, common		
verloren gehn	Verb		
begehren	Verb		
Lust, Begierde	Noun, common, masculine	2960	LONGING (WISH)
ersehnt	Adjective		
taüschen	Verb		
verführen, irre führen	Verb		
Lwddomaeis	Noun, proper		
Lwsanius	Noun, proper		
Lwstrws	Noun, proper		
Maeinan	Noun, proper		
können, vermögen	Verb	972	BE ABLE
gelten, bedeuten	Verb		
Jungfrauschaft	Noun, common, feminine		
Jungfrau	Noun, common, feminine		
Magdalan	Noun, proper		
Magdalene	Noun, proper		
Knäblein	Noun, common, masculine		
Knabe	Noun, common, masculine	1366	BOY
Mahath	Noun, proper		
mächtig; möglich	Adjective	3001	POWERFUL
vergewaltigen; rauben; kränken, quälen; erpressen; mißhandeln	Verb	1952	TORTURE
mahts	<none>		
Macht, Kraft, Vermögen	Noun, common, feminine	2526	POWER
tauschen	Verb	2509	EXCHANGE
verwandeln	Verb		
Mist	Noun, common, masculine		
Mailaian	Noun, proper		
Runzel	Noun, common		
Mailkei	Noun, proper		
Pergament	Noun, common, masculine		
gemein machen	Verb		
verunreinigen	Verb		
mehr	Adverb, Comparative	1992	MORE
Maisaullam	Noun, proper		
der größte	Adverb, Superlative		
höchstens	Adverb, Comparative		
etw schneiden, hauen von	Verb		
abhauen, abschneiden	Verb		
beschneiden	Verb		
zerschneiden, verschneiden	Verb		
ausschneiden, abschneiden, ausrotten	Verb		
Geschenk	Noun, common	2982	GIFT
größer	Adjective, Comparative		
Makeibis	Noun, proper		
Makidoneis	Noun, proper		
Makidonja	Noun, proper		
Makmas	Noun, proper		
mahlen	Verb	1033	GRIND
[Malailaiel]	Noun, proper		
Malkus	Noun, proper		
Sand	Noun, common, masculine	671	SAND
Motte	Noun, common	2828	MOTH
zermalmen	Verb		
Mambres	Noun, proper		
Fleisch	Noun, common, feminine	634	MEAT
mammona	Noun, common		
verhöhnen	Verb		
meinen, glauben, dafür halten	<none>	1890	BELIEVE
Fülle	Noun, common, feminine		
Menge	Noun, common, feminine	2987	AMOUNT
mannigfaltig	Adjective		
etw mehren	Verb		
reichlich vorhanden sein, Überfluß haben an	Verb		
sich vermehren zu	Verb		
mancher, viel	Adjective	1198	MANY
Menschenmörder	Noun, common, masculine		
Welt, Menschheit	Noun, common, feminine	965	WORLD
der Gestalt nach	Noun, common		
Bild	Noun, common, masculine	3303	PICTURE (PAINTING)
manna	Noun, common		
Mensch, mann	Noun, common, masculine	683	PERSON
niemand	Pronoun, indefinite	3887	NOBODY
Menschlichkeit	Noun, common, masculine		
menschlich	Adjective		
Bereitschaft	Noun, common, feminine		
etw bereitmachen, zurechtmachen	Verb		
etw vorbereiten	Verb		
einem etw bereiten zu	Verb		
etw vorher zubereiten	Verb		
bereit	Adjective		
der Herr kommt	Foreign word		
Meer	Noun, common, feminine	1474	SEA
Maria	<none>		
Perle	Noun, common	3325	PEARL
See	Noun, common, masculine	624	LAKE
Marja	Noun, proper		
Mark, Grenze	Noun, common, feminine	2546	BORDER
Marcellus von Ancyra	Noun, proper		
[ga-markon]	Verb		
Markus	Noun, proper		
Martyrer	Noun, common		
Marþa	Noun, proper		
Ärgernis	Noun, common, feminine		
einen ärgern, ihm zum Ärgernis sein	Verb		
Ärgernis nehmen	Verb		
Ärgernis erregen	Verb		
Ranzen, Speisesack	Noun, common, masculine		
essen	Verb	1336	EAT
essen	Verb	1336	EAT
Speise	Noun, common, masculine	256	FOOD
Mattaþanis	Noun, proper		
Mattaþius	Noun, proper		
Matþaius	Noun, proper		
Matþat	Noun, proper		
Wurm	Noun, common, masculine	1219	WORM
Versammlungsort, Marktplatz	Noun, common		
Rede, Redeweise	Noun, common, feminine	1115	SPEECH
reden	Verb	2708	TALK
Maþusalis	Noun, proper		
einen erinnern	Verb		
einen erinnern an	Verb		
Morgen	Noun, common, masculine	1339	MORNING
verkürzen	Verb		
sorgen für 	Verb		
Mord	Noun, common, neuter	845	MURDER
morden	Verb		
Mädchen	Noun, common, feminine	1646	GIRL
Mädchen	Noun, common, feminine	1646	GIRL
Eidam	Noun, common, masculine		
mein	Pronoun, possesive	2090	MY
Schwert	Noun, common		
Zeit, Stunde	Noun, common, neuter	892	TIME
Scheffel	Noun, common, masculine		
schreiben	Verb	1672	WRITE
aufschreiben	Verb		
vorzeichnen, vormalen	Verb		
schreiben	Verb	1672	WRITE
vorher schreiben	Verb		
unterschreiben	Verb		
etw überschreiben	Verb		
Mond	Noun, common, masculine	1313	MOON
Monat	Noun, common, masculine	1370	MONTH
Verkündigung, Predigt	Noun, common, feminine		
Merila	Noun, proper		
Gerücht, Kunde	Noun, common, feminine		
etw künden, kund tun	Verb		
Verkündiger, Prediger	Noun, common, masculine		
verkünden	Verb		
einem eine frohe Botschaft künden	Verb		
lästern	Verb	3641	SLANDER
sich  verbreiten	Verb		
Tisch; Schüssel, Platte; Kelter	Noun, common, neuter	1775	TABLE
Zwischenwand	Noun, common		
Überflutung, Sintflut	Noun, common, feminine		
midjis	Adjective		
die bewohnte Erde, der Erdkreis	Noun, common, masculine		
Mitte	Noun, common, feminine	1093	MIDDLE
Mittler	Noun, common, masculine		
Größe	Noun, common, feminine	2845	SIZE (OF OBJECT)
Größe	Noun, common, feminine	2845	SIZE (OF OBJECT)
preisen	Verb		
preisen	Verb		
verherrlicht werden	Verb		
groß	Adjective	1202	BIG
hochmütig	Adjective		
Milde	Noun, common, feminine		
Wolke	Noun, common, masculine	1489	CLOUD
die Soldaten	Verb		
Honig	Noun, common, neuter	942	HONEY
Milch	Noun, common, feminine	635	MILK
mimz	Noun, common		
der kleinste, geringste	Adjective, Superlative		
kleiner, geringer	Adjective, Comparative		
minder, weniger	Adverb, Comparative		
abnehmen	Verb	2864	DECREASE
Missetat	Noun, common, feminine		
verschieden	Adjective	2504	DIFFERENT
Zwiespalt, Mißrede	Noun, common, feminine		
Übeltäter	<none>		
einander	Adverb		
Maß	Noun, common, feminine		
messen	Verb	1506	MEASURE
zumessen	Verb		
wandeln, sich benehmen, leben	Verb	1422	BE ALIVE
Maß	Noun, common, feminine		
ermessen, denken, überlegen	Verb	1415	THINK (REFLECT)
vergessen	Verb	1523	FORGET
Überlegung, Gedanke	Noun, common, feminine	2975	THOUGHT
mit, bei, unter	Preposition, +D	1485	BELOW OR UNDER
Zwischenwand	<none>		
inzwischen	Adverb		
während	Conjunction		
Bewußtsein, Gewissen	Noun, common, feminine		
Lohn	Noun, common, feminine	1122	WAGES
zornig auf 	Adjective		
ermüdet	<none>	1757	TIRED
Moses	Noun, proper		
Zoll	Noun, common, feminine		
Raum finden	Verb		
Zöllner	Noun, common, masculine		
Zollstätte	Noun, common, masculine		
einem begegnen	Verb		
einem begegnen	Verb		
Zorn	Noun, common, masculine		
Nachgiebigkeit, Sanftmut	Noun, common, feminine		
Staub	Noun, common, feminine	2	DUST
von Staub, irdisch	Adjective		
einem das Maul verbinden	Verb		
meinen, glauben, dafür halten	Verb	1890	BELIEVE
sich einer Sache	Verb		
etw zu tun gedenken, wollen	Verb	1784	WANT
einen besehn, sehen auf	Verb		
Ziel	Noun, common, feminine		
vergessen	Verb	1523	FORGET
Gedanke, Meinung	Noun, common, masculine	2975	THOUGHT
Mund	Noun, common, masculine	674	MOUTH
Nabaw	Noun, proper		
Natter	Noun, common		
[Naem]	Noun, proper		
Naggai	Noun, proper		
festnageln an	Verb		
es ist erlaubt, nötig	Verb		
es genügt einem	Verb		
Nahasson	Noun, proper		
, Abendessen, Abendmahl, Gastmahl	Noun, common, masculine		
Nacht	Noun, common, feminine	1233	NIGHT
Naiman	Noun, proper		
Lästerung	Noun, common, feminine		
beschimpfen	Verb		
Naitofaþeis	Noun, proper		
Nakor	Noun, proper		
nennen	Verb	180	CALL BY NAME
benennen	Verb	180	CALL BY NAME
Name	Noun, common, neuter	1405	NAME
Mut fassen, sich erkühnen	Verb		
aufhören	Verb	1928	CEASE
Nacktheit	Noun, common, feminine		
nackt	Adjective	590	NAKED
Narde	Noun, common, masculine		
Rettung, Heil	Noun, common, feminine		
retten	Verb	2008	RESCUE
Heiland	Noun, common, masculine		
erretten, herstellen	Verb	2886	PRODUCE
Netz	Noun, common, neuter	2963	NET
netzen	Verb		
benetzen	Verb		
Naþan	Noun, proper		
November	Foreign word	2854	NOVEMBER
Kette, Handschellen	Noun, common, feminine	1627	CHAIN
notwendig	Adjective		
Notwendigkeit	Noun, common, feminine		
Nauel	Noun, proper		
noch	Adverb	2919	STILL (CONTINUING)
noch	Unassigned	2919	STILL (CONTINUING)
noch	Unassigned	2919	STILL (CONTINUING)
und sogar noch	Unassigned		
Naum	Noun, proper		
der Tote	Noun, common, masculine		
nötigen	Verb		
durch Zwang veranlassen	Verb		
Not, Zwang	Noun, common, feminine		
tot	Adjective	1625	DEAD
begraben	Verb	1719	BURY
einen mit jemand  begraben	Verb		
Nazaraiþ	Noun, proper		
Nazoräer, Nazarener	Noun, proper		
Nazoräer, Nazarener	Noun, proper		
nein	Unassigned	1269	NO
nahe	Adverb	1942	NEAR
näher	Adverb, Comparative		
nahe	Adverb, locative	1942	NEAR
sich einem nähern	Verb		
herannahen	Verb		
der Nächste	Noun, common, masculine		
nicht	Unassigned	1240	NOT
Neid	Noun, common, neuter	40	ENVY
Nekaudemus	<none>		
es auf jemand abgesehn haben	Verb		
Nerins	Noun, proper		
Nadel	Noun, common, feminine	1382	NEEDLE (FOR SEWING)
nicht	Unassigned	1240	NOT
doch nicht etwa	Unassigned		
das Verzehren, der Rost	Noun, common		
und nicht, auch nicht, nicht	Unassigned	1240	NOT
Nikaudemus	Noun, proper		
nehmen, annehmen, aufnehmen, empfangen, fangen	Verb	1749	TAKE
abnehmen, wegnehmen	Verb	2864	DECREASE
annehmen, aufnehmen, empfangen	Verb	694	GET
aufnehmen; wohin versetzen	Verb		
wegnehmen	Verb		
besitzen	Verb	684	OWN
nehmen	Verb	1749	TAKE
mitnehmen	Verb		
hernehmen	Verb		
annehmen, gelten lassen	Verb		
herausnehmen, wegnehmen	Verb		
genesen, errettet werden	Verb	1978	RECOVER
nist	Unassigned		
helfen	Verb	1897	HELP
Verwandter	Noun, common, masculine		
die Verwandte	Noun, common, feminine		
nicht	Unassigned	1240	NOT
Heimsuchung	Noun, common, feminine		
auskundschaften, ausspionieren	Verb		
erneuern	Verb		
 der Neubekehrte, der Neuling	Participle, past		
neu	Adjective	1231	NEW
Neuheit	Noun, common, feminine		
Unverstand	Noun, common, feminine		
unmündig, kindisch	Adjective		
neun	Numeral, cardinal	1483	NINE
der neunte	Numeral, ordinal		
neunzig	Numeral, cardinal	1724	NINETY
treffen, erreichen; einer Sache froh sein	Verb	1831	MEET
ergreifen, erwischen	Verb	855	SEIZE
die er uns reichlich gewährte	Verb		
zur Genüge versehn sein mit 	Verb		
auf dem Achterdeck	Noun, common		
nun, jetzt	Adverb	1376	NOW
denn	Unassigned		
demnach, daher	Unassigned		
Fänger, Fischer	Noun, common, masculine	1858	FISHERMAN
Nwmfan	Noun, proper		
ach, pfui	Interjection		
Obeid	Noun, proper		
Odueia	Noun, proper		
sich fürchten vor 	Verb		
einen schrecken	Verb		
Zeit habend	<none>		
Osaiin	Noun, proper		
osanna	Foreign word		
Leibrock, Unterkleid	Noun, common, feminine		
 bekleiden	Verb		
paintekuste	Noun, common		
Paitrus	Noun, proper		
Presbyter, Geistlicher	Noun, common		
Tröster	Noun, common, masculine		
Rüsttag	Noun, common		
paska	Noun, common		
pasxa	<none>		
Pauntius	Noun, proper		
Purpur	Noun, common		
paurpaura	<none>		
purpurn	Adjective		
Pawlus	Noun, proper		
Palmbaum	Noun, common, masculine		
Peilatus	Noun, proper		
unverfälschte o flüssige Narde	Adjective		
Straße	Noun, common, feminine	667	ROAD
Flicken	Noun, common		
tanzen	Verb	1879	DANCE
bedrängen	Verb		
praitoriaun	Noun, common		
christlich Gemeindebehörde	Noun, common, feminine		
praizbwtairi	Noun, common, neuter		
Prophetin	Noun, common, feminine		
Prophet	Noun, common		
Weissagung	Noun, common		
weissagen	Verb		
Priska	Noun, proper		
Psalm	Noun, common		
Geldbeutel	Noun, common		
Pfund	Noun, common		
weinen, trauern	Verb	1839	CRY
Sanftmut	Noun, common, feminine		
sanft, freundlich gegen	Adjective	1856	SOFT
Pfahl, Stachel	Noun, common, neuter	3798	STINGER
Quartus	Noun, proper		
Eheweib	Noun, common, feminine		
kommen	Verb	1446	COME
hinzutreten	Verb		
einen überfallen	Verb		
vor jemand hergehn	Verb		
etw verzehren, ausgeben, vertun	Verb		
zusammenkommen	Verb		
mitkommen mit	Verb		
umbringen, den Tod geben	Verb	1417	KILL
weiblichen Geschlechts	Adjective		
Frauenzimmer, Weibsleute	Adjective		
femina, Weib	Noun, common, feminine	962	WOMAN
Verderben	Noun, common, feminine	92	SPOIL (SOMEBODY OR SOMETHING)
verderben	Verb	92	SPOIL (SOMEBODY OR SOMETHING)
verderben, umbringen	Verb	92	SPOIL (SOMEBODY OR SOMETHING)
verderben, umbringen	Verb	92	SPOIL (SOMEBODY OR SOMETHING)
umkommen, zugrunde gehn	Verb	2865	DIE (FROM ACCIDENT)
sagen	Verb	1458	SAY
verzichten auf	Verb		
verleumden, verlästern	Verb		
Abschied nehmen 	Verb		
sich entschuldigen	Verb		
vorhersagen	Verb		
für ungültig erklären, aufheben	Verb	371	PICK UP
sich verabreden, übereinkommen, beschließen	Verb		
mitsprechen, nachsprechen	Verb		
ein Gerede verbreiten	Verb		
die Schwangere	Noun, common, feminine		
Magen; Mutterschoß	Noun, common, masculine	819	STOMACH
beleben	Verb		
beleben	Verb		
mitbeleben	Verb		
aufleben	Verb		
lebendig	Adjective	1422	BE ALIVE
Feuchtigkeit	Noun, common, feminine		
das Kommen; Gegenwart, Ankunft, Wiederkunft Christi	Noun, common, masculine	1446	COME
rabbaunei	Foreign word		
rabbei	Foreign word		
Ragaw	Noun, proper		
Rat, Beschluß	Noun, common, neuter		
Ratgeber, Ratsherr	Noun, common, masculine		
etw verwalten	Verb		
einen Rat geben	Verb		
rechnen	Verb	2867	CALCULATE
einen übertreffen an	Verb		
abschätzen	Verb		
darreichen	Verb		
Raibaikka	Noun, proper		
verordnen	Verb		
befehlen, verordnen, bestimmen	Verb	1998	COMMAND
nämlich, doch, etwa	Conjunction		
als gerecht erweisen	Verb		
vollends in Ordnung bringen	Verb		
recht, grade	Adjective	1062	LAW
recht, richtig	Adverb, Comparative	1725	CORRECT (RIGHT)
zum Aufstehn bringen, aufrichten, erwecken	Verb		
raka	Foreign word		
aufrecken	Verb		
Rama	Noun, proper		
aufgehn lassen	Verb		
Meile	Noun, common, feminine		
zählen	Verb	1420	COUNT
Abrechnung, Konto; Zahl	Noun, common, feminine	1356	NUMBER
leichter	Adjective, Comparative		
einen berauben	Verb		
erzürnt werden	Verb		
raufen	Verb		
Rohr	Noun, common, neuter	2956	TUBE
rot	Adjective	156	RED
Sprache, Sprechweise	Noun, common, feminine	1307	LANGUAGE
Haus	Noun, common, neuter	1252	HOUSE
Vorsorge treffen für	Verb		
einen vorherbestimmen zu	Verb		
besorgen, gewähren	Verb		
warum lasset ihr euch Satzungen auflegen, als lebtet ihr in der Welt	Verb		
Reich, Herrschaft, Obrigkeit	Noun, common, neuter	712	RICH
herrschen über	Verb		
reikeis	Adjective		
reiks	Adjective		
Herrscher, Obrigkeit	Noun, common, masculine	3377	EMPEROR
zittern	Verb	52	SHIVER
erzittern, erbeben	Verb		
das Zittern	Noun, common, feminine	52	SHIVER
erstehn, sich erheben	Verb	570	STAND UP
Resa	Noun, proper		
Regen	Noun, common, neuter	658	RAIN (PRECIPITATION)
regnen	Verb	1253	RAIN (RAINING)
häufen	Verb		
Ruhe	Noun, common, neuter	3458	SILENCE
rennen, laufen	Verb	1519	RUN
streiten	Verb	3302	QUARREL (VERB)
hinzulaufen	Verb		
hinzulaufen	Verb		
einen umringen	Verb		
hinzulaufen	Verb		
sich erstrecken, reichen zu	Verb		
vorhergehn	Verb		
sich verlaufen zu, geraten unter	Verb		
zusammenlaufen, zusammenkommen	Verb		
zufallen, zuteil werden	Verb		
auslaufen, ausgehn	Verb		
Gießbach	Noun, common, feminine		
Finsternis	Noun, common, neuter		
finster	Adjective		
finster werden	Verb		
Vernichtung, vom ewigen Tod gesagt	Noun, common, feminine		
verderben	Verb	92	SPOIL (SOMEBODY OR SOMETHING)
vergänglich, sterblich	Adjective		
riurs	Adjective		
sprechen, reden	Verb	1623	SPEAK
murrend reden, murren	Verb		
mit einem reden	Verb		
Hof	Noun, common, feminine	4	COURTYARD
Rufus	Noun, proper		
Raum	Noun, common	1450	ROOM
Rūma	Noun, proper		
sich erweitern	Verb		
Rūmoneis	Noun, proper		
geräumig	Adjective		
Geheimnis	Noun, common, feminine		
Lauf	Noun, common, masculine		
der, dieser	Pronoun, demonstrative	1214	THIS
Sabellius	Noun, proper		
feine Leinwand	Noun, common		
Sabaoþ	Noun, proper		
sabbato	Noun, common, masculine		
Saddukaieis	Noun, proper		
satt	<none>	106	SATIATED
der	Pronoun, relative		
senken	Verb		
versenken	Verb		
uf-saggqjan	<none>		
Untergang, Westen	Noun, common	1817	WEST
Vorlesung, Rezitation	Noun, common, masculine		
der u kein andrer, eben der	Pronoun, demonstrative		
was auch immer	Pronoun, indefinite		
ecce, sieh	Adverb		
säen	Verb	748	SOW SEEDS
einsäen	Verb		
sechs	Numeral, cardinal	1703	SIX
der sechste	Numeral, ordinal		
sehn	Verb		
auf etw sehn, es berücksichtigen	Verb		
auf etw sehn, acht geben	Verb		
umsehn	Verb		
erblicken	Verb		
hinsehn; auf etw sehn, nach etw sehn	Verb		
dúrchschauen	Verb		
aufblicken	Verb		
anseilen	Verb		
Sailaum	Noun, proper		
Saimaiein	Noun, proper		
zögern, säumen	Verb	3629	HESITATE
Schmerz	Noun, common, neuter	1783	PAIN
Sairok	Noun, proper		
Seele	Noun, common, feminine	811	SOUL
See	Noun, common, masculine	624	LAKE
Saixaineia	Noun, proper		
streiten	Verb	3302	QUARREL (VERB)
widersprechen, bekämpfen	Verb		
schelten	Verb		
vorstellen, anraten; eintreten für; bezeichnen	Verb	180	CALL BY NAME
ana-insakan	Verb		
erörtern, vorlegen	Verb		
Streit	Noun, common, feminine		
Sack	Noun, common, masculine	2990	SACK
streitsüchtig	Adjective		
Salamis	Noun, proper		
Salaþiel	Noun, proper		
salben	Verb		
salben	Verb		
Salbe	Noun, common, feminine	1926	OINTMENT
leichtfertiges Geschwätz	Noun, common, feminine		
Herberge	Noun, common, feminine		
opfern	Verb		
darbringen	Verb		
zum Opfer bringen	Verb		
herbergen, bleiben	Verb	987	REMAIN
Herberge nehmen	Verb		
Salmon	Noun, proper		
Salome	Noun, proper		
Salz	Noun, common, neuter	1274	SALT
salzen	Verb		
derselbe, der nämliche	Pronoun		
samafraþjis	Adjective		
desselben Geschlechts, verwandt	Adjective		
gleich groß	Adjective		
gleich	Adjective	2276	IDENTICAL
auf gleiche Weise, gleich-, ebenfalls	Adverb	2276	IDENTICAL
zusammen, zugleich	Adverb	2482	TOGETHER
Übereinstimmung	Noun, common, feminine		
Samareites	Noun, proper		
Samaria	Noun, proper		
einmütig	Adjective		
nach einem und demselben Ort hin; zusammen	Adverb	2482	TOGETHER
die den Menschen zu gefallen suchen	Verb		
senden	Verb		
entsenden, geleiten	Verb		
vorausentsenden	Verb		
entsenden	Verb		
mitentsenden	Verb		
mitentsenden	Verb		
aussenden	Verb		
Saraipta	Noun, proper		
Sarra	Noun, proper		
Waffen	Noun, common, neuter		
Satan	Noun, proper		
setzen	Verb	1649	SIT DOWN
absetzen, entlassen	Verb	1095	LET GO OR SET FREE
darstellen	Verb		
umgeben	Verb		
hinsetzen, hinstellen, hinlegen	Verb	998	PUT
vorstellen, darstellen	Verb		
versetzen	Verb		
setzten darauf	Verb		
satt	Adjective	106	SATIATED
Saudauma	Noun, proper		
Krankheit	Noun, common, feminine	1986	DISEASE
Sonne	Noun, common, neuter	1343	SUN
Saulaumon	Noun, proper		
besudeln	Verb		
besudelt werden	Verb		
Säule	Noun, common, feminine		
Syrer	Noun, common, masculine		
Saurais	Noun, proper		
Sorge, Kummer	Noun, common, feminine	1668	GRIEF
sorgen, bekümmert sein	Verb	253	CARE FOR
Syrerin	Noun, common, feminine		
Grund	Noun, common, feminine	2968	REASON
Opfer	Noun, common, masculine	1103	SACRIFICE
sei	<none>		
Seidona	Noun, proper		
Seidoneis	Noun, proper		
Seimon	Noun, proper		
Seina	Noun, proper		
sich	Pronoun, personal, reflexive		
selbstsüchtig	Adjective		
sein, ihr	Pronoun, possesive, reflexive	1213	YOU
täglich	Adjective		
spät	Adjective	477	LATE
Tüchtigkeit, Güte	Noun, common, feminine		
gut, gütig	Adjective	1035	GOOD
Sem	Noun, proper		
Seþ	Noun, proper		
sibakþanei	Foreign word		
Sippenverhältnis, Verwandtschaft	Noun, common, feminine		
sich mit einem  versöhnen	Verb		
sieben	Numeral, cardinal	1704	SEVEN
siebzig	Numeral, cardinal	1721	SEVENTY
üben	Verb		
Sitte, Gewohnheit	Noun, common, masculine	1747	CUSTOM
sich freuen, frohlocken	Verb	1495	HAPPY
singen; vorlesen, rezitieren	Verb	1261	SING
vorlesen, rezitieren	Verb		
Sieg	Noun, common, neuter	783	VICTORY
Siegeslohn	Noun, common, neuter		
einen mit einem Siegel versehn, ihn siegeln	Verb		
versiegeln	Verb		
besiegeln, bestätigen	Verb		
Siegel	Noun, common, neuter		
sinken	Verb	1088	SINK (DESCEND)
untersinken	Verb		
versinken, untergehn	Verb	1088	SINK (DESCEND)
sihw	Unassigned		
Sekel	Noun, common, masculine		
verstummen	Verb		
selbst	Pronoun	1993	SELF
Silvanus	Noun, proper		
Augenzeuge	Noun, common, masculine		
freiwillig	Adjective		
Staunen, Verwunderung	Noun, common, neuter		
anstaunen, bewundern	Verb		
bewundert werden	Verb		
erstaunlich, wunderbar	Adjective		
Siloam	Noun, proper		
Silber	Noun, common, neuter	759	SILVER
silbern	Adjective		
einst, vordem	Adverb, temporal	2914	ONCE (IN THE PAST)
Senf	Noun, common		
sineigs	Adjective		
der Älteste	Adjective, Superlative		
täglich	Adjective		
immer, allezeit	Adverb	1676	ALWAYS
Gang	Noun, common, masculine	2979	WALK (MANNER)
Sion	Noun, proper		
Schüler, Jünger	Noun, common, masculine		
jemandes Schüler sein	Verb		
sitzen	Verb	1416	SIT
scheuen, Rücksicht nehmen	Verb		
herumsitzen, herumwohnen	Verb		
Nachbar	Noun, common, masculine	1332	NEIGHBOUR
ergreifen	Verb	855	SEIZE
sich niedersetzen, Platz nehmen	Verb		
sich aufsetzen, sich aufrichten	Verb		
Sitz	Noun, common, masculine		
nähen	Verb	1457	SEW
siechen, krank sein	Verb	1847	SICK
Krankheit	Noun, common, feminine	1986	DISEASE
krank, schwach	Adjective	1601	WEAK
Gesicht, das Sehen, Sehkraft; Gestalt, sinnfällige Erscheinung; Augenschein; Gesicht, Vision	Noun, common, feminine	1560	FACE
schaben, scheren	Verb	1532	SHEAR
schaben, scheren	Verb	1532	SHEAR
Schatten	Noun, common, masculine	1388	SHADE
überschatten	Verb		
sich bereit machen	Verb		
scheiden, trennen	Verb	1359	SEPARATE
absondern, abtrennen	Verb		
zerteilen	Verb		
sich zurückziehn	Verb		
geschieden werden	Verb		
schuldig sein, sollen	<none>		
Ziegel	Noun, common, feminine		
Knechtschaft, Dienst; Gottesdienst	Noun, common, masculine		
einem dienen	Verb		
Mitknecht sein, mitdienen	Verb		
Knecht, Diener	Noun, common, masculine	812	SLAVE
sich schämen	Verb	1894	ASHAMED
beschämt werden	Verb		
Schande	Noun, common, feminine		
erschaffen	Verb		
Skariotau	<none>		
daß sie nüchtern werden, zur Besinnung kommen aus den Schlingen des Teufels	Verb		
Wechsler	Noun, common, masculine		
Geld, Geldstück; Mine	Noun, common, masculine	1559	MONEY
schädlich	<none>		
Schaden, Unrecht	Noun, common, neuter	2947	DAMAGE (INJURY)
schaden	Verb	2947	DAMAGE (INJURY)
einem Schaden zufügen in	Verb		
schädlich	Adjective		
Riemen	Noun, common	2973	STRAP
anmutig	Adjective		
skauneis	Adjective		
Skorpion	Noun, common, feminine	1538	SCORPION
Zipfel	Noun, common		
daß sie nüchtern werden, zur Besinnung kommen aus den Schlingen des Teufels	<none>		
Leuchte	Noun, common		
scheinen, leuchten; aufblitzen	Verb	1521	SEEM
umleuchten	Verb		
Auslegung, Erklärung	Noun, common, feminine		
erklären	Verb	1626	EXPLAIN
klar, deutlich	Adjective	989	CLEAR
wandern	Verb		
Schild	Noun, common, masculine	1064	SHIELD
Fleischer	Noun, common, masculine	2569	BUTCHER
Schilling	Noun, common, masculine		
Schiff	Noun, common, neuter	740	SHIP
verstoßen, von sich wegstoßen	Verb		
Schuh	Noun, common, masculine	1381	SHOE
böser Geist, Dämon	Noun, common, neuter		
etw zerreißen	Verb		
zerreißen	Verb	1735	TEAR (SHRED)
Haupthaar	Noun, common		
Spiegel	Noun, common, masculine	1171	MIRROR
Schuldner, der Schuldige	Noun, common, masculine		
schuldig sein, sollen	Verb		
Schauer	Noun, common, feminine		
Skwþus	Noun, proper		
Raufbold	Noun, common, masculine		
schlagen	Verb	3308	STRIKE (SOMEONE)
abschlagen	Verb		
Schlag	Noun, common, masculine		
schlicht; glatt, eben	Adjective	1234	SMOOTH
das Schlachten	Noun, common, feminine	1796	SLAUGHTER
abstreifen, ablegen	Verb		
in Angst versetzen	Verb		
erschrecken	Verb	252	FRIGHTEN
schweigen	Verb	48	BE SILENT
verstummen	Verb		
verstummen	Verb		
Schaden	Noun, common, feminine	2947	DAMAGE (INJURY)
Gefahr	Noun, common, feminine	1810	DANGER
beschädigen	Verb	1116	DAMAGE
schlimm, gefährlich	Adjective	419	SEVERE
sleideis	Adjective		
schlafen	Verb	1585	SLEEP
entschlummern, entschlafen	Verb		
entschlummern, entschlafen	Verb		
Schlaf	Noun, common	2972	SLEEP (STATE)
verschlingen, verschlucken	Verb		
schleichen, schlüpfen	Verb	3116	HATCH (OUT)
einschleichen	Verb		
Fett	Noun, common, neuter	323	FAT (ORGANIC SUBSTANCE)
Feige	Noun, common, masculine	322	FIG
Feigenbaum	Noun, common, masculine		
der Kleinste	Adjective, Superlative		
Mist, Kot	Noun, common, feminine	675	FAECES (EXCREMENT)
bestreichen	Verb		
aufstreichen auf	Verb		
 bewirken	Verb		
Myrrhe	Noun, common, neuter		
Gewand, Mantel	Noun, common, masculine	603	COAT
Schnee	Noun, common, masculine	784	SNOW
anfassen, anrühren	Verb		
schneiden; ernten	Verb	1432	CUT
af-sneiþan	Verb		
schlachten	Verb	1796	SLAUGHTER
eilen	Verb	2860	BOLT (MOVE IN HASTE)
hineilen, kommen	Verb	1446	COME
eilends	Adverb		
eiliger	Adverb, Comparative		
eilen	Verb	2860	BOLT (MOVE IN HASTE)
hinzueilen	Verb		
zuvorkommen	Verb		
vorangehn	Verb		
vorwegnehmen	Verb		
ereilen, gelangen zu	Verb		
Korb	Noun, common, feminine	1539	BASKET
Weisheit	Noun, common, feminine		
weise	Adjective	698	WISE
der, dieser	<none>	1214	THIS
Forscher	Noun, common, masculine		
das Suchen	Noun, common, feminine	1468	LOOK FOR
suchen	Verb	1468	LOOK FOR
aufsuchen	Verb		
mitdisputieren	Verb		
erforschen	Verb		
Disputation, Streitfrage, Grübelei	Noun, common, feminine		
Soseipatrus	Noun, proper		
Sättigung	Noun, common		
ersättigen	Verb		
Späher, Ordonnanz	Noun, common		
Speichel	Noun, common	1503	SALIVA
Sperling	Noun, common, masculine	1854	SPARROW
Rennbahn	Noun, common, feminine		
speien	Verb	1278	VOMIT
entgegenspeien	Verb		
bespeien	Verb		
ausspeien	Verb		
spät	Adjective, Comparative	477	LATE
der jüngste Tag	Adjective, Superlative		
spedumists	Adjective, Superlative		
Tafel	Noun, common, feminine	3084	BLACKBOARD
Sage, Fabel	Noun, common, neuter		
Verkündiger	Noun, common, masculine		
künden	Verb		
verkünden	Verb		
Gutes, frohe Botschaft künden	Verb		
verkünden, erzählen	Verb	1711	TELL
verkünden, erzählen	Verb	1711	TELL
spinnen	Verb	121	SPIN
schnell, bald	Adverb	1631	FAST
aus Binsen o Palmblättern geflochtener Korb	Noun, common, masculine		
Grundstoffe, Elemente	Noun, common, masculine		
stich aus	Verb		
etwas anstoßen an	Verb		
Staifanus	Noun, proper		
Steig, Weg	Noun, common, feminine	2252	PATH
steinig	Adjective		
steinern	Adjective		
steinigen	Verb		
Stein	Noun, common, masculine	857	STONE
Stern	Noun, common, feminine	1430	STAR
die Unfruchtbare	Noun, common, feminine		
Mal, Wundmal	Noun, common, masculine		
einen versehn mit	Verb		
erwerben, bekommen	Verb	694	GET
lallend, stammelnd	Adjective		
stehn	Verb		
abstehn, ablassen, abfallen	Verb		
entgegenstehn, widerstehn, widerstreiten	Verb		
dabei stehn	Verb		
herumstehn, umringen	Verb		
Vorsteher	Verb		
stehn bleiben, halt machen	Verb		
daß der Tag bevorsteht	Verb		
zusammenstehn mit	Verb		
sich trennen, Abschied nehmen von	Verb	1359	SEPARATE
sich erheben, aufbrechen, auferstehn	Verb	570	STAND UP
Ufer, Gestade	Noun, common	3464	SHORE OF LAKE
Stätte, Ort ; Raum, Platz	Noun, common, masculine	723	PLACE (POSITION)
Gericht, Urteil, Streitsache	Noun, common, feminine	1068	COURT
Richter	Noun, common, masculine	861	JUDGE
Richterstuhl	Noun, common, masculine		
vertrocknen	Verb		
sie bezeigten ihr Unwillen	Verb		
stoßen an	Verb		
steigen	Verb	705	GO UP (ASCEND)
hinabsteigen	Verb	2014	GO DOWN (DESCEND)
hineinsteigen	Verb		
darüber empor steigen	Verb		
emporsteigen	Verb		
Stimme	Noun, common, feminine	1363	VOICE
stich aus	<none>		
stoßen	Verb	1452	PUSH
anstoßen an	Verb		
anstoßen	Verb		
Becher, Kelch	Noun, common, masculine	476	CUP
Stich, Punkt	Noun, common, masculine		
stehlen	Verb	713	STEAL
Stier, Kalb	Noun, common, masculine	1989	CALF
aufstellen, geltend machen	Verb	3833	PUT (IN A STANDING POSITION)
Geduld, geduldiges Ertragen	Noun, common, neuter		
anfangen, anheben	Verb	1806	BEGIN
anfangen, anheben	Verb	1806	BEGIN
stojan	Verb		
ein Urteil abgeben über urteilen	Verb		
Stuhl, Thron	Noun, common, masculine	1476	CHAIR
Wesen, Gegenstand, Zuversicht, Erwartung	Noun, common	2981	ITEM
aufrecht erhalten	Verb		
streuen	Verb		
bestreuen	Verb		
darunterstreuen, únterbreiten	Verb		
Strich	Noun, common, masculine	2993	STROKE (OF PEN)
Staub	Noun, common, masculine	2	DUST
Sohle	Noun, common, feminine	2666	SOLE (FOOT)
das Fundament legen, begründen	Verb		
teils __ teils __ teils	Adverb		
irgend einer, ein gewisser, jemand, einer	Pronoun, indefinite	2422	SOMEONE
abgesondert, besonders, allein	Adverb	1964	ALONE
Wahrheit	Noun, common, feminine	1638	TRUTH
Sunjaifriþas	Noun, proper		
wahr, wahrhaft	Adjective	1657	TRUE
wahrhaft	Adjective		
entschuldigen	Verb		
rechtfertigen	Verb		
Verteidigung	Noun, common, feminine		
Sonne	Noun, common	1343	SUN
alsbald, plötzlich, auf einmal	Adverb	1963	IMMEDIATELY
sogleich	Adverb	1963	IMMEDIATELY
sobald als	Conjunction		
Sohn	Noun, common, masculine	1620	SON
würzen	Verb		
würzen	Verb		
wegen deines Magens	Noun, common		
Susanna	Noun, proper		
nachgiebig, mild	Adjective		
kitzeln	Verb	3647	TICKLE (SOMEBODY)
suþjon	Verb		
so	Adverb	2336	OF THIS KIND (SUCH)
so daß, daher, also	Conjunction		
schwankend machen	Verb		
so 	Adverb	2336	OF THIS KIND (SUCH)
Schwiegervater	Noun, common, masculine	1055	FATHER-IN-LAW
Schwiegermutter	Noun, common, feminine	1050	MOTHER-IN-LAW
abwischen, auslöschen	Verb	1454	WIPE
abwischen, abtrocknen mit	Verb	1454	WIPE
so groß	Adjective		
so beschaffen, ein solcher	Adjective		
Schwamm	Noun, common		
schwören	Verb	1939	SWEAR
beschwören	Verb		
falsch schwören	Verb		
ohne Grund, vergebens, umsonst	Adverb	1765	IN VAIN
Tinte	Noun, common		
swartizla	<none>		
schwarz	Adjective	163	BLACK
sowie, gleichwie, wie	Adverb	1239	HOW
so nun	Unassigned		
so	Unassigned	2336	OF THIS KIND (SUCH)
wie	Adverb	1239	HOW
Jubel, Frohlocken	Noun, common, feminine		
jubeln, triumphieren	Verb		
ablassen	Verb		
Schwein	Noun, common, neuter	1337	PIG
ehren	Verb	3628	HONOR (SOMEBODY)
verherrlichen	Verb		
verunehren, beschimpfen	Verb		
Ehre	Noun, common, feminine		
geehrt, geachtet	Adjective		
eigen, angehörig	Adjective		
Eigentum, Vermögen	Noun, common, neuter		
doch zwar, wenigstens	Particle		
Schwefel	Noun, common	3386	SULPHUR
Flötenspieler	Noun, common, masculine		
Flöte blasen, aufspielen	Verb		
Jubel, Frohlocken	<none>		
Reinheit, Keuschheit	Noun, common, feminine		
Reinigung	Noun, common, feminine		
Reinheit, Keuschheit	Noun, common, feminine		
rein, unschuldig; unsträflich	Adjective	704	CLEAN
etw bekannt geben	Verb		
offenkundig, offenbar, bekannt	Adjective	3005	FAMILIAR
im Sterben liegen	Verb		
sterben	Verb	1494	DIE
miþ-gaswiltan	Verb		
Stärke, Kraft	Noun, common, feminine	202	STRENGTH
stärken	Verb		
stärken	Verb		
stark werden	Verb		
erstarken	Verb		
stark, kräftig, gesund	Adjective	785	STRONG
Schwester	Noun, common, feminine	1263	SISTER
Swmaion	Noun, proper		
Synagogenvorsteher	Noun, common, masculine		
swnagoge	Noun, common, feminine		
Swntwke	Noun, proper		
seufzen	Verb		
erseufzen	Verb		
aufseufzen	Verb		
Swria	Noun, proper		
dem Tode nahe	Noun, common, masculine		
Teich	Noun, common, neuter		
Haar	Noun, common, neuter	1040	HAIR
Zähre, Träne	Noun, common, neuter	1651	TEAR (OF EYE)
weinen	Verb	1839	CRY
reißen, zerren	Verb	460	BREAK (OF ROPE)
zerstreuen	Verb	3705	SCATTER
rechts	Adjective	1019	RIGHT
die Rechte	Noun, common, feminine		
zehn	Numeral, cardinal	1515	TEN
der zehnte	Numeral, ordinal		
hundertfältig	Adjective		
 Hundert	Numeral, cardinal	1634	HUNDRED
mit fünf zehnreihigen  Hundert	Adjective		
Anzeichnen	Noun, common, neuter		
einem etwas Zeigen	Verb		
ein Zeichen geben, belehren	Verb		
bezeichnen; auszeichnen; erweisen	Verb	180	CALL BY NAME
Zeichen, Wunder	Noun, common, feminine	1720	SIGN
korb	Noun, common, feminine	1539	BASKET
Zweig	Noun, common, masculine	3222	TWIG
zerreißen	Verb	1735	TEAR (SHRED)
zerreißen, zerstören, aufheben	Verb	681	DESTROY
Tairtius	Noun, proper		
taitrarkes	Noun, common		
Mägdlein	Foreign word		
Lehre, Unterweisung	Noun, common, feminine		
lehren, ziehen, unterrichten	Verb	1455	PULL
Lehrer	Noun, common	1038	TEACHER
belehren, erziehen	Verb		
bezähmen, bezwingen	Verb		
brennen machen, zünden	Verb		
mit einem Brandmal versehn	Verb		
in Brand setzen, verbrennen	Verb	141	BURN (SOMETHING)
kennzeichnen	Verb		
brich los, brich in Jubel aus	Verb		
berauben	Verb		
Werk, Tat	Noun, common, neuter		
tun, machen	Verb	734	MAKE
, vollbringen, bewirken	Verb		
Übeltäter	Verb		
abreißen	Verb	1735	TEAR (SHRED)
zerreißen	Verb	1735	TEAR (SHRED)
was zu nichte wird, das Vergängliche	Verb		
Teibairius	Noun, proper		
anzeigen, verkündigen	Verb		
vorherverkündigen, vorhersagen	Verb		
anrühren	<none>		
Teimaius	Noun, proper		
Teimauþaius	Noun, proper		
Teitus	Noun, proper		
anrühren	Verb		
berühren	Verb	1892	TOUCH
Ordnung	Noun, common, feminine		
durch Wahl bestimmt, verordnet	Verb		
Tibairiadau	Noun, proper		
Bewohner von Tiberias	Noun, proper		
Dekaden; bildet die Zehner von	Unassigned		
einem anhangen	Verb		
erlangen	Verb		
zusammenfügen	Verb		
damit sie Gelegenheit fänden ihn anzuklagen	Unassigned		
geziemen für 	Verb		
bauen	<none>	1840	BUILD
Erbauung	Noun, common, feminine		
Zimmermann	Noun, common, masculine	1042	CARPENTER
bauen	Verb	1840	BUILD
daraufbauen	Verb		
erbauen	Verb		
mit	Verb	1340	WITH
ziehn, führen	Verb	43	LEAD (GUIDE)
wegziehn	Verb		
herbeiziehn, herbeiführen, herbeibringen	Verb		
hineinziehn, hineinführen	Verb		
 umherführen	Verb		
wegziehn, wegführen	Verb		
mit	Verb	1340	WITH
hinausführen, wegführen	Verb		
Tobeias	Noun, proper		
Trakauneitidaus	Noun, proper		
Vertrauen, Zuversicht	Noun, common, feminine		
trauen, Zutrauen haben	Verb		
vertrauen	Verb		
Trauadai	Noun, proper		
Bündnis, Bund	Noun, common, neuter		
Bündnis, Bund	Noun, common, feminine		
treu, zuverlässig	Adjective	100	FAITHFUL
treulich, zuverlässig	Adverb, Comparative		
Trauer	Noun, common, feminine		
einen bedrängen	Verb		
Holz, Prügel	Noun, common, neuter	1803	WOOD
hölzern	Adjective		
treten	Verb	1135	KICK
zertreten	Verb		
einpfropfen	Verb		
überstreuen	Verb		
Gestirn	Noun, common, neuter		
Zunge	Noun, common, feminine	1205	TONGUE
Festigkeit, Sicherheit; Fundament ; Feste, Bollwerk	Noun, common, feminine		
festigen, stärken	Verb	1094	FASTEN
befestigen, bestärken	Verb		
fest, beständig	Adjective	3003	SOLID
brennen	Verb	1428	BURNING
verbrennen	Verb	141	BURN (SOMETHING)
Zahn	Noun, common, masculine	1380	TOOTH
twai	Numeral, cardinal		
zwölfjährig	Adjective		
zwölf	Numeral, cardinal	1707	TWELVE
das Zweifeln	Noun, common, feminine	3536	DOUBT (SOMETHING)
zweifeln o Zweifel erregen	Verb		
Zweifel	Noun, common		
zwischen beiden Grenzen	Numeral, other		
Zwistigkeit	Noun, common, feminine		
Twkeikus	Noun, proper		
Twra	Noun, proper		
Þaddaius	Noun, proper		
wohin	Adverb	2928	WHITHER (WHERE TO)
Dank	<none>		
denken, überlegen	Verb	1415	THINK (REFLECT)
mir fällt ein, was ich tun soll	Verb		
etw bedenken	Verb		
das Schweigen	Noun, common, feminine	48	BE SILENT
schweigen	Verb	48	BE SILENT
verstummen	Verb		
Lehm	Noun, common, feminine	1399	CLAY
Þaiaufeilus	Noun, proper		
durch	Preposition, +A	97	THROUGH
Loch, Nadelöhr	Noun, common, neuter	1667	HOLE
verdorren	Verb		
Þaissaloneikai	Noun, proper		
Þaissalauneikaie	Noun, proper		
dann, darauf	Adverb, temporal	2921	THEN
weiter, noch mehr	Adverb		
weiter, noch	Adverb	2919	STILL (CONTINUING)
so lange als	Conjunction		
wann	Conjunction	1238	WHEN
ausdehnen, sich ausstrecken	Verb		
Dank	Noun, common		
ja, wohl, also darum	Adverb	1268	YES
þanuh	Adverb		
dort	Adverb, locative	1937	THERE
Þara	Noun, proper		
Mangel, Armut	Noun, common, feminine		
sich enthalten	Verb		
nötig	Adjective		
wo	Adverb	1237	WHERE
nötig haben, bedürfen, Mangel leiden	<none>	2339	NEED (SOMETHING)
ungewalkt	Adjective		
da	Adverb	1937	THERE
der, dieser	<none>	1214	THIS
das eine	Unassigned		
nur	Adverb	1580	ONLY
daß	Conjunction		
das ist, nämlich	Unassigned		
der u kein andrer, eben der	<none>		
daher, von da	Adverb		
von wannen	Adverb		
von da, daher	Adverb		
als	Unassigned		
wenn auch	Conjunction		
nötig haben, bedürfen, Mangel leiden	Verb	2339	NEED (SOMETHING)
nötig	Adjective		
Bedürfnis, Not	Noun, common, feminine		
von Dornen	Adjective		
Dorn	Noun, common, masculine	124	THORN
bebautes Land, Acker	Noun, common, neuter	212	FIELD
mich dürstet	Verb		
dursten	Verb	3474	BE THIRSTY
verdorren, vertrocknen	Verb		
Durst	Noun, common, feminine		
dürr	Adjective		
um so	Unassigned		
darum, daß	Unassigned		
so lange als	Particle		
gedeihn, Fortschritte machen	Verb		
vorwärtskommen	Verb		
übertreffen	Verb		
Zeit	Noun, common, neuter	892	TIME
Donner	Noun, common, feminine	1150	THUNDER
dein	Pronoun, possesive	732	YOUR (SINGULAR)
Knechte	Noun, common, neuter		
heranziehn	Verb		
meist, vorzüglich	Adverb		
wohin auch immer	Adverb		
wer auch immer	<none>		
wo auch immer	Adverb		
wer auch immer	Pronoun, indefinite		
Diebstahl	Noun, common, neuter		
verstohlen, heimlich	Adverb		
Heiden	Noun, common, feminine		
Königsschloss	Noun, common, feminine		
herrschen	Verb		
mitherrschen mit	Verb		
König	Noun, common, masculine	1508	KING
Regierung	Noun, common, masculine		
heidnisch	Adverb		
Dieb	Noun, common, masculine	1160	THIEF
Knecht	Noun, common, masculine	812	SLAVE
Haussklave, Diener	Noun, common, masculine		
das Gute, die gute Sache	Noun, common, neuter		
gut, gepriesen	Adjective	1035	GOOD
Güte	Noun, common, feminine		
Segen	Noun, common, feminine		
segnen	Verb	391	BLESS
einem  den Segen geben	Verb		
fluchen	Verb		
Knechtschaft	Noun, common		
unterjochen, in Dienstbarkeit bringen	Verb		
unterjochen, in Dienstbarkeit bringen	Verb		
Magd	Noun, common, feminine		
schrecken	Verb		
erschrecken	Verb	252	FRIGHTEN
ermahnen	Verb		
zart	Adjective		
Flucht	Noun, common, masculine		
þliuhan	Verb		
wegfliehn	Verb		
die Flucht ergreifen, entfliehn	Verb		
entfliehn, einem entrinnen	Verb		
Þomas	Noun, proper		
Tröstung	Noun, common, feminine		
trösten, mahnen	Verb		
erquicken	Verb		
ga-þrafstjan	Verb		
laufen	Verb	1443	WALK
herbeilaufen	Verb		
Heuschrecke	Noun, common, feminine	810	LOCUST
Streitsucht	Noun, common, feminine		
drängen	Verb		
bedrängen	Verb		
Teich	Noun, common, neuter		
drei	Numeral, cardinal	492	THREE
der dritte	Numeral, ordinal	1859	THIRD
dreschen	Verb	285	THRESH
einem Beschwerde bringen	Verb		
üben	Verb		
Übung, Stählung	Verb		
Aussatz	Noun, common, neuter	3624	LEPROSY
aussätzig	Adjective		
du	Pronoun, personal	1215	THOU
der du	Pronoun, personal, relative	1215	THOU
glauben, meinen; gelten	Verb	1890	BELIEVE
Gewissen	Noun, common, masculine		
das Dulden, Leiden, die Geduld	Noun, common, feminine		
dulden	Verb		
erdulden	Verb		
erdulden, ertragen	Verb	833	ENDURE
tausend	Noun, common, feminine	1843	THOUSAND
Anführer von Tausend	Noun, common, masculine		
Trompete	Noun, common, neuter	775	TRUMPET
trompeten	Verb		
etw waschen	Verb		
sich abwaschen	Verb		
sich abwaschen	Verb		
etwas auswaschen, abwaschen	Verb		
Bad, Taufe	Noun, common, neuter		
Zorn, Streit, Streitigkeit	Noun, common, feminine		
zornig	Adjective		
Sicherheit	Noun, common, feminine		
befestigen	Verb		
Rauchopfer	Noun, common, masculine		
-u	Particle, enclitic		
übel, böse	Adjective	45	EVIL
übeltäterisch	Adjective		
schmähn	<none>		
schmähsüchtig	Adjective		
Halle	Noun, common, feminine		
unter	Preposition, +AD	1485	BELOW OR UNDER
durch Eid verpflichtet, verbunden	Adjective		
über	Preposition, +AD	1741	ABOVE
überfließend, überschwänglich machen	Verb		
Überfluß, Übermaß	Noun, common, masculine		
Überfülle, Überfluß	Noun, common, feminine		
übervoll	Adjective		
Oberpriester	Noun, common, masculine		
das Überhören, der Ungehorsam	Noun, common, feminine	3813	DISOBEDIENT
himmlisch	Adjective		
darüber hinaus	Unassigned		
Vergessenheit	Noun, common, feminine		
Überschrift	Noun, common, feminine		
Überschrift	Noun, common, neuter		
darüber	Adverb		
Besprengung	Noun, common, feminine		
Erstlingsfrucht	Noun, common, feminine		
Meineidiger	Noun, common, masculine		
Gehorsam	Noun, common, feminine		
Unterordnung, Gehorsam	Noun, common, feminine		
Ufitahari	Noun, proper		
es ist überflüssig für mich euch zu schreiben	Unassigned		
Erkenntnis	Noun, common, neuter		
Aufgeblasenheit, Hochmut	Noun, common, feminine		
oft	Adverb, temporal	1852	OFTEN
vielleicht	Adverb	2278	PERHAPS
die verheiratete Frau	Unassigned	426	MARRIED WOMAN
uns beide	Pronoun, personal		
und, nun, also	Particle, enclitic	1577	AND
sich fürchten vor 	<none>		
Zeit habend	Adjective		
zur rechten Zeit	Adverb, Comparative		
gelegen	Adjective		
Morgendämmerung	Noun, common, feminine		
Kamel	Noun, common	1871	CAMEL
furchtlos	Participle, present		
furchtlos	Unassigned		
unheilig, gottlos	Adjective		
der sich nicht zu schämen braucht, ohne Schande	Adjective		
unsichtbar	Adverb		
unenthüllt	Participle, past		
unbestritten	Participle, past		
unbestreitbar	Adjective		
unzugänglich	Adjective		
nicht tragend	Participle, present		
kinderlos	Adjective		
ungeboren	Participle, past		
das Ungesäuertsein	Noun, common, feminine		
ungesäuert	Participle, past		
wildes Tier, Bestie	Noun, common, neuter		
unaufspürbar, unbegreiflich	Participle, past		
Nichtbeschneidigung, Vorhaut	Noun, common, neuter		
unbeschnitten	Participle, past		
unbrauchbar	Adjective		
bis zu	Preposition, +AD		
unter etw	Preposition, +A		
das Innere	Adjective, Superlative		
der Allergeringste	Noun, common, masculine		
unter	Preposition, +D	1485	BELOW OR UNDER
Frühstück	Noun, common, masculine	1322	BREAKFAST
Unsterblichkeit	Noun, common, feminine		
unpassend, undankbar	Adjective		
tadellos	Adjective		
untadelig	Adverb		
unaufspürbar, unerforschlich	Participle, past		
geschwätzig	Adjective		
unvorsätzlich, ohne Vorbedacht	Adjective		
unverständig	Participle, present		
Schonungslosigkeit, Härte	Noun, common, feminine		
Unverstand, Torheit	Noun, common, feminine		
unverständig	Adjective		
tadellos; unbescholten	Participle, present		
tadellos	Participle, past		
zügellos, sich nicht beherrschend	Participle, present		
Unmäßigkeit, Unenthaltsamkeit	Noun, common, feminine		
unfügsam, ungehorsam	Adjective	3813	DISOBEDIENT
nicht probehaltig, verwerflich	Participle, past		
Unglaube, Ungehorsam	Noun, common, feminine	3813	DISOBEDIENT
ungläubig, ungehorsam	Participle, present	3813	DISOBEDIENT
wertlos	Adjective		
Gesetzlosigkeit, Ungerechtigkeit	Noun, common, feminine		
ungesehn, unsichtbar	Participle, past		
ohne festen Stand, ohne bleibende Stätte	Adjective		
ungeordnet, zügellos	Adjective		
ungeordnet	Participle, past		
unbewegt, unbeweglich	Participle, past	1636	MOTIONLESS
nicht habend	Participle, present		
Schwäche, Krankheit	Noun, common, neuter	1986	DISEASE
krank	Adjective	1847	SICK
nicht mit der Hand gemacht	Adjective		
ungeheuchelt	Adjective		
Unreinigkeit	Noun, common, feminine		
Unreinigkeit	Noun, common, feminine		
unrein; ungebildet	Adjective		
Unhold, Teufel	Noun, common, masculine		
Unholdin, Dämon	Noun, common, feminine		
ohne Opfer, unversöhnlich	Adjective		
unauslöschlich	Participle, present		
unablässig	Adjective		
sorglos	Adjective		
unkaureins	Noun, common, feminine		
Unze	Noun, common, masculine		
nicht kennend, unwissend	Participle, present	2651	BE IGNORANT
Unkunde	Noun, common, neuter		
unbekannt	Adjective		
Armut	Noun, common, neuter		
arm	Adjective	1674	POOR
ungeliebt, unlieb	Adjective		
unverheiratet	Participle, past		
nicht lügend	Participle, present		
ungeheuchelt, ohne Falsch	Adjective		
Unlust	Noun, common, masculine		
ohnmächtig, schwach	Adjective	1601	WEAK
Ohnmacht, Schwäche, Krankheit	Noun, common, feminine	1986	DISEASE
ungezähmt, wild oder unfreundlich, barsch	Adjective	2966	PERCH (FISH)
unvorbereitet	Adjective		
lieblos	Adjective		
unnütz, töricht	Adjective		
unbeweibt	Participle, past		
unaussprechlich	Adjective		
Unvergänglichkeit	Noun, common, feminine		
unvergänglich	Adjective		
unriurs	Adjective		
nicht redend, stumm	Participle, present	1666	MUTE
unbestritten	Adverb		
nicht sehend	Participle, present		
ungesalzen	Participle, past		
unser	Pronoun, possesive	780	OUR
Bosheit, Schlechtigkeit	Noun, common, feminine		
übel, böse	Adjective	45	EVIL
ungesetzlich, gottlos	Adjective		
laßt uns nüchtern sein	Adjective		
Aufstand	Noun, common, neuter		
unaufhörlich	Participle, present		
Unehre	Noun, common, feminine		
Unehre	Noun, common, feminine		
nicht geachtet, verachtet	Adjective		
unbekannter	Adjective		
unfügsam, unbotmäßig, ungehorsam	Adjective	3813	DISOBEDIENT
bis, so lange als	Conjunction		
voreilig, unbesonnen	Adjective		
untreu	Adjective		
Unvolk, Nicht	Noun, common, feminine	1240	NOT
das Böse	Noun, common, neuter	45	EVIL
ungewaschen	Participle, past		
unanstößig	Participle, present		
zur Unzeit	Adverb		
unbelehrt	Participle, past		
nicht auszuerzählen, unerforschlich	Participle, past		
tadellos	Adjective		
unwürdig	Adverb		
Unbeflecktheit	Noun, common, feminine		
fleckenlos, tadellos	Adjective		
untätig, müßig	Noun, common, feminine		
ungebildet, unwissend	Adjective	2651	BE IGNORANT
unerwartet, plötzlich	Adverb	2920	SUDDENLY
Unwille	Noun, common, feminine		
ungewiß, ins ungewisse	Adjective		
Unwissender, Unverständiger	Noun, common, masculine		
unwissend	Participle, present	2651	BE IGNORANT
Unwissenheit, Unverstand	Noun, common, neuter		
beängstigt, bekümmert	Participle, present		
aus, von 	<none>	693	FROM
Auferstehung	Noun, common, feminine		
verworfen	Adjective		
Abtritt	Noun, common, masculine		
Ausgang	Noun, common, feminine		
aus, von 	Preposition, +D	693	FROM
Frechheit; fortwährende Zänkerei	Noun, common, feminine		
Geduld, Langmut	Noun, common, feminine		
geduldig, langmütig	Adjective	3884	PATIENT
Erwartung; Geduld, Langmut	Noun, common, feminine		
Bitte, Flehn	Noun, common, feminine		
Ausdauer; Eifer	Noun, common, feminine		
eifrig	Adjective		
usdaudoza	Adjective, Comparative		
eifrig	Adverb		
rauhe Wege	Noun, common, feminine		
tadellos	Adjective		
Ausfahrt	Noun, common, feminine		
Begräbnis	Noun, common, neuter		
sie entsetzten sich über	Adjective		
Entsetzen	Noun, common, feminine		
Nahrung	Noun, common, feminine	256	FOOD
Erfüllung	Noun, common, feminine		
mutlos	Adjective		
Mangel leidend	Adjective		
bekannt, offenbar	Adjective	3005	FAMILIAR
Erlösung	Noun, common, feminine		
gichtbrüchig, Gichtbrüchiger	Adjective		
erschließen, öffnen	<none>	1156	OPEN
Eröffnung, Öffnung	Noun, common, neuter		
Erlösung	Noun, common, feminine		
Lebensführung; Lebenswandel	Noun, common, neuter		
Beschuldigung, Anklage	Noun, common, feminine		
Ursprung	Noun, common, feminine		
am meisten, besonders	Adverb		
laßt uns nüchtern sein	<none>		
Auferstehung	Noun, common, feminine		
Zügellosigkeit, Lüderlichkeit	Noun, common, feminine		
zügellos	Adverb		
Auszeichnung, Bezeichnung; Bekanntmachung; Anzeichen, Beweis	Noun, common, feminine		
Vollendung, Vervollkommnung; Ende; Erfüllung	Noun, common, feminine	743	END (OF TIME)
Übung, Stählung	Noun, common, feminine		
Geduld	Noun, common, feminine		
erwachsen	Participle, past		
Wachstum	Noun, common, feminine		
Umwälzung; Zusammensturz; Zerstörung; Untergang	Noun, common, feminine		
das Abwenden, Irreleiten	Noun, common, feminine		
gerecht	Adjective		
Gerechtigkeit	Noun, common, feminine		
Auswurf; Verwerfung; Fehlgeburt	Noun, common, feminine		
außer der Weihe	Adjective		
hoffnungslos	Adjective		
losgebunden	Adjective		
Leichtfertigkeit, Eitelkeit	Noun, common, neuter		
hinaus, heraus	Adverb, directional		
außerhalb, draußen	Adverb, locative	762	OUTSIDE
von außen, außen	Adverb, directional		
von außen	Adverb, directional		
Krippe	Noun, common, masculine		
aus, von 	<none>	693	FROM
Pfand	Noun, common, neuter		
Handschein, Schuldschein	Noun, common, feminine		
zusammenfügen, verloben	Verb		
Kopfkissen	Noun, common		
Paradies	Noun, common, masculine		
schütteln	Verb	1909	SHAKE
bewegen, abbringen	Verb	765	MOVE
einen in Bewegung setzen	Verb		
erregen, aufwiegeln	Verb		
erregen	Verb		
wachsen	Verb	479	GROW
überaus wachsen, sich stark vermehren	Verb		
erwachsen	<none>		
Wuchs	Noun, common, masculine	2528	SIZE (OF PERSON)
Wache	Noun, common, feminine	1940	GUARD
wehe	Interjection		
wehn	Verb		
umwinden, umgeben, umkleiden	Verb		
Übeltäter, Räuber	Noun, common, masculine		
Kampf	Noun, common, feminine		
Winkel, Ecke	Noun, common, masculine	192	CORNER
Eckstein	Noun, common, masculine		
nichts	Noun, common, neuter	687	NOTHING
Ding, Sache, Etwas	Noun, common	738	THING
wohl, gut	Adverb	1035	GOOD
Wohltat	Noun, common, feminine		
guter Ruf	Noun, common, feminine		
Verkündigung	Noun, common, feminine		
wohllautend, löblich	Adjective		
Segen	Noun, common, feminine		
victus, gute Nahrung	Noun, common, feminine		
elend, geplagt	Adjective		
daß doch, wenn doch	Interjection		
verbinden	Verb	2862	CONNECT
Kranz	Noun, common, masculine		
Mann	Noun, common, masculine	1554	MAN
männlich	Adverb		
Gastfreund, Hauswirt	Noun, common, masculine		
Lippe	Noun, common, feminine	478	LIP
werfen	Verb	1456	THROW
etw wegwerfen	Verb		
hinwerfen	Verb		
verwerfen, zerstreuen	Verb	3705	SCATTER
hinwerfen	Verb		
hineinwerfen	Verb		
hinauswerfen, wegwerfen, austreiben	Verb	3696	THROW AWAY
schlimmer	Adverb, Comparative		
schlimmer	Adjective, Comparative		
Preis	Noun, common	657	PRICE
werden	Verb	1990	BECOME
verderben	Verb	92	SPOIL (SOMEBODY OR SOMETHING)
Tüchtigkeit, Fähigkeit	Noun, common, feminine		
versöhnen mit	Verb		
sich versöhnen mit	Verb		
schätzen	Verb		
wert, würdig, tauglich	Adjective		
auf etw sehn, acht geben, es bewachen, hüten, etw halten	<none>	2885	HERD (SOMETHING)
vielleicht, etwa	Adverb	2278	PERHAPS
schlechter Ruf	Noun, common, feminine		
Lästerung	Noun, common, feminine		
wachen	Verb		
durchwachen	Verb		
erwecken	Verb		
erwachen	Verb	1602	WAKE UP
walten	Verb		
sich der Herrschaft bemächtigen, einen vergewaltigen	Verb		
Gewalt, Macht über	Noun, common, neuter	2976	VIOLENCE
echt, lauter	Adjective		
wählen	Verb	1750	CHOOSE
erwählen	Verb		
sich wälzen	Verb		
etw umwälzen, umstürzen	Verb		
hin und her wälzen	Verb		
Stab	Noun, common, masculine		
sich wälzen	Verb		
wegwälzen	Verb		
hinzuwälzen	Verb		
vorwälzen	Verb		
Bauch, Schoß	Noun, common, feminine	1251	BELLY
Fleck	Noun, common		
beflecken	Verb		
Mangel	Noun, common, neuter		
Mangel	Noun, common, feminine		
wenden	Verb	1445	TURN (SOMETHING)
abwenden	Verb		
zuwenden	Verb		
vermeiden	Verb		
wenden	Verb	1445	TURN (SOMETHING)
verdrehn	Verb		
sich wegwenden	Verb		
Rute	Noun, common, masculine		
Mangel	Noun, common, masculine		
mangelhaft, fehlend	Adjective		
Wächter	Noun, common, masculine		
verderben	Verb	92	SPOIL (SOMEBODY OR SOMETHING)
Tücke, Verschlagenheit	Noun, common, feminine		
Verdammungsurteil, Verurteilung	Noun, common, feminine		
einen verurteilen zu 	Verb		
wehren	Verb	1330	DEFEND
wärmen	Verb		
behutsam, nüchtern	Adjective		
einen kleiden	Verb		
entkleiden	Verb		
bekleiden mit	Verb		
Kleid	Noun, common, feminine	474	DRESS
Wasser	Noun, common, neuter	948	WATER
Wort	Noun, common, neuter	1599	WORD
seiner vernünftigen Natur gemäß	Adjective		
Wortstreit	Noun, common, feminine		
widersprechen	Verb		
viel Worte machen	Verb		
schmähn	Verb		
machen, wirken	Verb	734	MAKE
etw erwirken	Verb		
eine Sünde begehen	Verb		
bewirken, erwirken, bereiten	Verb		
ausführen, vollbringen	Verb		
Wurm, Schlange	Noun, common, masculine	730	SNAKE
Werk, Tat; Wirksamkeit	Noun, common, neuter		
Arbeiter	Noun, common, masculine	2977	WORKER
das Tun	Noun, common, feminine	813	DO
wirksam	Adjective		
Arbeiter	Noun, common, masculine	2977	WORKER
Wurzel	Noun, common, feminine	670	ROOT
Erschütterung, Sturm; Wellenschlag, Brandung	Noun, common, masculine	858	STORM
Priester	Noun, common, masculine	852	PRIEST
kämpfen	Verb	1423	FIGHT
widerstreiten	Verb		
weihen, heiligen	Verb		
weihen, heiligen	Verb		
Weihe, Heiligung, Heiligkeit	Noun, common, feminine		
heilig werden	Verb		
heilig	Adjective	1702	HOLY
Dorf, Weiler	Noun, common, neuter	930	VILLAGE
Wein	Noun, common, neuter	1524	WINE
Weinbeere	Noun, common, neuter		
Weingarten, Weinberg	Noun, common, masculine		
Weinrebe	Noun, common, masculine		
Weinstock	Noun, common, neuter		
Weintrinker, Säufer	Noun, common, masculine		
trunken, Trunkenbold	Unassigned		
kränzen, krönen	Verb		
wir	Pronoun, personal	1212	WE
überreden	Verb		
vollenden oder beglaubigen	Verb		
heimsuchen, besuchen, besorgen	Verb	1377	VISIT
einem Recht verschaffen, ihn rächen an	Verb		
die Proskynesis, Verehrung erweisen, begrüßen	Verb		
gespannt hinblicken auf	Verb		
schmähn	Verb		
Zeugnis	Noun, common, feminine		
Zeugnisablegung, Zeugnis	Noun, common, feminine		
Zeugnis	Noun, common, neuter		
Zeugnisablegung, Zeugnis	Noun, common, feminine		
zeugen, bezeugen	Verb	1152	BEGET
mitzeugen	Verb		
Zeuge	Noun, common, masculine		
warten, hoffen auf 	Verb	1590	WAIT (FOR)
auf einen vorher hoffen	Verb		
erwarten, annehmen	Verb		
Hoffnung	Noun, common, feminine		
Waffen	Noun, common, neuter		
Wereka	Noun, proper		
zweifeln	Verb	3536	DOUBT (SOMETHING)
unwillig sein, zürnen	Verb	2223	BE ANGRY
zusammenbinden, verbinden	Verb	2862	CONNECT
verleugnen	Verb		
Waise	Noun, common, masculine	1149	ORPHAN
Witwe	Noun, common, feminine	1756	WIDOW
Dornpflanzen	Noun, common, feminine		
bewegen	Verb	765	MOVE
zum Kriege	Noun, common		
Weg	Noun, common, masculine	2252	PATH
in der Reihenfolge seiner Tagesklasse, da seine Tagesklasse an der Reihe war	Noun, common, feminine		
Wille	Noun, common, masculine		
Parteilichkeit	Noun, common, feminine		
wollen	Verb	1784	WANT
Wiljariþ	Noun, proper		
wild	Adjective	2230	UNTAMED OR WILD
räuberisch, Räuber	Noun, common, masculine		
rauben	Verb		
ausplündern, berauben	Verb		
fortreißen	Verb		
umwinden	Verb		
du-gawindan	Verb		
flechten	Verb	3294	BRAID (VERB) OR WEAVE (BASKET)
Wind	Noun, common, masculine	960	WIND
Weide	Noun, common, feminine	649	PASTURE
Leiden	Noun, common, feminine		
leiden	Verb		
erleiden	Verb		
Leiden	Noun, common, feminine		
Jahr	Noun, common, masculine	1226	YEAR
Worfschaufel	Noun, common, feminine		
zermalmen	Verb		
Kranz	Noun, common, feminine		
Meeresstille	Noun, common, neuter		
sein, dasein, existieren	Verb	1579	BE
da sein	Verb		
vorhanden ist	Verb		
verbrauchen, vergeuden	Verb	2787	CONSUME (DRINK OR EAT)
als der Sabbat vorüber war	Verb		
beistehn, zu Hilfe kommen	Verb		
überragend sein	Verb		
sich freuen, schwelgen, schmausen	Verb	1495	HAPPY
sich freuen, schwelgen, schmausen	Verb	1495	HAPPY
weilen, bleiben	Verb	987	REMAIN
verweilen, verbleiben	Verb		
mit einem zusammen verweilen	Verb		
verbleiben, verharren	Verb	987	REMAIN
Wesen, Natur	Noun, common, feminine	3897	NATURE
wit	Pronoun, personal		
wissen	Verb	1410	KNOW (SOMETHING)
ich bin mir nichts bewußt	Verb		
auf etw sehn, acht geben, es bewachen, hüten, etw halten	Verb	2885	HERD (SOMETHING)
Gesetzeskundiger	Noun, common, masculine		
Gesetzeslehrer	Noun, common, masculine		
gesetzlos	Adjective		
gesetzlich	Adverb		
Gesetz	Noun, common, neuter	1062	LAW
Kenntnis, Erkenntnis	Noun, common, neuter		
schütteln	Verb	1909	SHAKE
wider, gegen	Preposition, +A	2469	AGAINST
gegenüberliegend, entgegengesetzt	Adjective		
 Lamm	Noun, common, masculine		
die Schwelgende	Verb		
sich umsehn	Verb		
Angesicht; Ansehn, Gestalt	Noun, common, masculine		
ins Gesicht schlagen, kasteien	Verb		
Wmainaius	<none>		
das Wachen	Noun, common, feminine		
Zins	Noun, common		
rufen	Verb	1084	CALL
herbeirufen	Verb		
aufschreien, ausrufen	Verb		
angenehm	Adjective		
wütend, besessen	Adjective	2223	BE ANGRY
krumm	Adjective	297	CROOKED
Verfolgung	Noun, common, feminine		
Verfolgung	Noun, common, feminine		
verfolgen	Verb	1047	PURSUE
Verfolger	Noun, common, masculine		
Reise	Noun, common, masculine	2393	JOURNEY
reisen	Verb		
Verfolgung	Noun, common, feminine		
Herde	Noun, common, masculine	2939	FLOCK (OF ANIMALS)
verfolgen	Verb	1047	PURSUE
verfolgen	Verb	1047	PURSUE
bestrafen, Rache nehmen an 	Verb		
Frucht bringen	Verb		
Strich	Noun, common, masculine	2993	STROKE (OF PEN)
Herde	<none>	2939	FLOCK (OF ANIMALS)
anklagen, beschuldigen	Verb	1814	ACCUSE
verklagen, verdächtigen	Verb	1841	SUSPECT
Klage, Anklage gegen	Noun, common, feminine		
Schlinge	Noun, common, feminine	2604	NOOSE
wallen, sieden	Verb	792	BOIL (OF LIQUID)
Wolf	Noun, common, masculine	522	WOLF
Wolle	Noun, common, feminine	964	WOOL
Tuchwalker	Noun, common, masculine		
herrlich, wunderbar	Adjective		
wertvoller	Adjective, Comparative		
Wert	Noun, common, feminine		
Herrlichkeit	Noun, common, masculine		
Raub	Noun, common, feminine		
verwunden	Verb		
wund	Adjective		
Geißel, Plage	Noun, common, feminine		
Leiden	Noun, common, feminine		
Xafira	Noun, proper		
Xreskus	Noun, proper		
Christus	Noun, proper		
Zaibaidaius	Noun, proper		
Zakarias	Noun, proper		
Zakkaius	Noun, proper		
Zauraubabil	Noun, proper		
Zaxxaius	Noun, proper		
Eiferer, Beiname des Simon	Noun, proper		
