Grapheme	IPA
Aai	aɛ
aba	aβa
abba	abːa
Abeileni	aβilenɪ
Abia	aβɪa
Abiaþar	aβɪaθar
Abraham	aβraham
biabrjan	bɪaβrjan
abrs	aβr̥s
abraba	aβraβa
abu	aβu
Adam	aðam
Addei	adːi
Addin	adːɪn
Adoneikam	aðonikam
af	aɸ
afar	aɸar
afara	aɸara
afardags	aɸardaɣs
afarsabbate	aɸarsabːate
afdauiþs	aɸdɔɪθs
afdomeins	aɸdomins
afdrugkja	aɸdruŋkja
afetja	aɸetja
afgrundiþa	aɸɡrundɪθa
afgudei	aɸɡuði
afguþs	aɸɡuθs
afhaimeis	aɸhɛmis
aflageins	aɸlaɣins
aflet	aɸlet
afmarzeins	aɸmarzins
afmauiþs	aɸmɔɪθs
afsateins	aɸsatins
afstass	aɸstasː
afta	aɸta
aftana	aɸtana
aftaro	aɸtaro
aftra	aɸtra
aftraanastodeins	aɸtraanastoðins
aftuma	aɸtuma
aftumists	aɸtumɪsts
agan	aɣan
Agar	aɣar
aggilus	aŋɡɪlus
aggwiþa	aɡɡwɪθa
gaaggwjan	ɡaaɡɡwjan
aggwus	aɡɡwus
agis	aɣɪs
afagjan	aɸaɣjan
inagjan	ɪnaɣjan
usagjan	usaɣjan
aglaitei	aɣlɛti
aglaitgastalds	aɣlɛtɡastalds
aglaiti	aɣlɛtɪ
aglaitiwaurdei	aɣlɛtɪwɔrdi
agliþa	aɣlɪθa
usagljan	usaɣljan
aglo	aɣlo
agls	aɣl̥s
aglus	aɣlus
agluba	aɣluβa
Agustus	aɣustus
aha	aha
ahaks	ahaks
ahana	ahana
Aharon	aharon
ahjan	ahjan
ahma	ahma
ahmateins	ahmatins
ahmeins	ahmins
ahs	ahs
ahtau	ahtɔ
ahtaudogs	ahtɔðoɣs
ahtautehund	ahtɔtehund
ahtuda	ahtuða
aƕa	aʍa
Aia	ɛa
Aibair	ɛβɛr
aibr	ɛβr̥
Aiddua	ɛdːua
Aieira	ɛira
Aifaisius	ɛɸɛsɪus
Aifaiso	ɛɸɛso
aiffaþa	ɛɸːaθa
aigan	ɛɣan
fairaihan	ɸɛrɛhan
aigin	ɛɣɪn
gaaiginon	ɡaɛɣɪnon
aihtron	ɛhtron
aihtrons	ɛhtrons
aihts	ɛhts
aiƕatundi	ɛʍatundɪ
afaikan	aɸɛkan
aikklesjo	ɛkːlesjo
Ailam	ɛlam
Aileiaizair	ɛliɛzɛr
Aileiakeim	ɛliakim
Aileisabaiþ	ɛlisaβɛθ
ailoe	ɛloe
Ailul	ɛlul
Aimmeira	ɛmːira
ainabaur	ɛnaβɔr
ainaha	ɛnaha
ainakls	ɛnakl̥s
ainamundiþa	ɛnamundɪθa
gaainan	ɡaɛnan
ainfalþei	ɛnɸalθi
ainfalþs	ɛnɸalθs
ainfalþaba	ɛnɸalθaβa
ainƕarjizuh	ɛnʍarjɪzuh
ainƕaþaruh	ɛnʍaθaruh
ainlif	ɛnlɪɸ
Ainnaa	ɛnːaa
Ainok	ɛnok
Ainos	ɛnos
ains	ɛns
ainshun	ɛnshun
Aiodia	ɛoðɪa
Aipafras	ɛpaɸras
Aipafraudeitus	ɛpaɸrɔðitus
aipiskaupei	ɛpɪskɔpi
aipiskaupus	ɛpɪskɔpus
aipistaule	ɛpɪstɔle
áir	ɛr
airis	ɛrɪs
Airastus	ɛrastus
airinon	ɛrɪnon
áirizans	ɛrɪzans
airkns	ɛrkn̥s
airkniþa	ɛrknɪθa
Airmodam	ɛrmoðam
Airmogaineis	ɛrmoɣɛnis
airþa	ɛrθa
airþakunds	ɛrθakunds
airþeins	ɛrθins
airus	ɛrus
airzei	ɛrzi
airzeis	ɛrzis
airziþa	ɛrzɪθa
airzjan	ɛrzjan
afairzjan	aɸɛrzjan
aistan	ɛstan
gaaistan	ɡaɛstan
aiþei	ɛθi
aiþs	ɛθs
aiþþau	ɛθːɔ
aiwaggeli	ɛwaŋɡelɪ
aiwaggelista	ɛwaŋɡelɪsta
aiwaggeljan	ɛwaŋɡeljan
aiwaggeljo	ɛwaŋɡeljo
aiweins	ɛwins
aiwiski	ɛwɪskɪ
aiwiskon	ɛwɪskon
gaaiwiskon	ɡaɛwɪskon
usaiwjan	usɛwjan
aiwlaugia	ɛwlɔɣɪa
Aiwneikai	ɛwnikɛ
aiws	ɛws
Aiwwa	ɛwːa
aiwxaristia	ɛwχarɪstɪa
aiz	ɛz
Aizaikeia	ɛzɛkia
aizasmiþa	ɛzasmɪθa
Aizleim	ɛzlim
Aizor	ɛzor
ajukdūþs	ajukduθs
ak	ak
Akaja	akaja
Akajus	akajus
Akaïkus	akɛ̈kus
akei	aki
aket	aket
akran	akran
akranalaus	akranalɔs
akrs	akr̥s
Akwla	akwla
alabalstraun	alaβalstrɔn
alabrunsts	alaβrunsts
Alaiksandrus	alɛksandrus
alakjo	alakjo
alamans	alamans
alamannans	alamanːans
Alamod	alamoð
alan	alan
alaþarba	alaθarba
aldomin	aldomɪn
alds	alds
aleina	alina
alew	alew
alewabagms	alewaβaɣm̥s
alewja	alewja
Alfaius	alɸɛus
alhs	alhs
alja	alja
aljakuns	aljakuns
aljaleiko	aljaliko
aljaleikos	aljalikos
aljaleikoþs	aljalikoθs
aljan	aljan
aljan	aljan
aljanon	aljanon
inaljanon	ɪnaljanon
aljar	aljar
aljaþ	aljaθ
aljaþro	aljaθro
aljis	aljɪs
allandjo	alːandjo
allaþro	alːaθro
allawaurstwa	alːawɔrstwa
allawerei	alːaweri
allis	alːɪs
alls	alːs
allwaldands	alːwaldands
usalþan	usalθan
alþeis	alθis
Alul	alul
Ameinadab	aminaðaβ
amen	amen
Ammo	amːo
ams	ams
amsa	amsa
an	an
ana	ana
anabusns	anaβusn̥s
anafilh	anaɸɪlh
anahaimeis	anahɛmis
anaks	anaks
anakunnains	anakunːɛns
analageins	analaɣins
analaugnei	analɔɣni
analaugns	analɔɣn̥s
analeiko	analiko
anamahts	anamahts
anaminds	anamɪnds
uzanan	uzanan
Ananias	ananɪas
Ananeias	ananias
ananiujiþa	ananɪujɪθa
anaqal	anakʷal
anaqiss	anakʷɪsː
anasiuns	anasɪuns
anastodeins	anastoðins
anaþaima	anaθɛma
Anaþoþ	anaθoθ
anawairþs	anawɛrθs
anawiljei	anawɪlji
and	and
andabauhts	andaβɔhts
andabeit	andaβit
andahafts	andahaɸts
andahait	andahɛt
andalauni	andalɔnɪ
andanahti	andanahtɪ
andaneiþa	andaniθa
andanem	andanem
andanemeigs	andanemiɣs
andanems	andanems
andanumts	andanumts
andasets	andasets
andastaþjis	andastaθjɪs
andastaua	andastɔa
andaþāhts	andaθahts
andaugi	andɔɣɪ
andaugiba	andɔɣɪβa
andaugjo	andɔɣjo
andawairþi	andawɛrθɪ
andawaurdi	andawɔrdɪ
andawizns	andawɪzn̥s
andawleizn	andawlizn̥
andbahti	andbahtɪ
andbahtjan	andbahtjan
andbahts	andbahts
andeis	andis
andhuleins	andhulins
andilaus	andɪlɔs
andizuh	andɪzuh
Andraias	andrɛas
andstald	andstald
andwairþi	andwɛrθɪ
andwairþs	andwɛrθs
Anna	anːa
Annas	anːas
anno	anːo
Ano	ano
ans	ans
ansteigs	anstiɣs
ansts	ansts
Antiaukia	antɪɔkɪa
anþar	anθar
anþarleikei	anθarliki
anþarleiko	anθarliko
Appaullo	apːɔlːo
apaustaulei	apɔstɔli
apaustaulus	apɔstɔlus
aqizi	akʷɪzɪ
ara	ara
Arabia	araβɪa
Araita	arɛta
Aram	aram
arbaidjan	arbɛðjan
biarbaidjan	bɪarbɛðjan
miþarbaidjan	mɪθarbɛðjan
þairharbaidjan	θɛrharbɛðjan
arbaiþs	arbɛθs
arbi	arbɪ
arbinumja	arbɪnumja
arbja	arbja
arbjo	arbjo
Areimaþaia	arimaθɛa
Areistarkus	aristarkus
Arfaksad	arɸaksað
arƕazna	arʍazna
arjan	arjan
arka	arka
arkaggilus	arkaŋɡɪlus
Arkippus	arkɪpːus
armahairtei	armahɛrti
armahairtiþa	armahɛrtɪθa
armahairts	armahɛrts
armaio	armɛo
arman	arman
gaarman	ɡaarman
arms	arm̥s
arms	arm̥s
arniba	arnɪβa
aromata	aromata
Artaksairksus	artaksɛrksus
arwjo	arwjo
Asaf	asaɸ
asans	asans
Aser	aser
Asgad	asɡað
Asia	asɪa
asiluqairnus	asɪlukʷɛrnus
asilus	asɪlus
Asmoþ	asmoθ
asneis	asnis
assarjus	asːarjus
Assaum	asːɔm
astaþ	astaθ
asts	asts
at	at
ataþni	ataθnɪ
Ater	ater
atgagg	atɡaŋɡ
atisk	atɪsk
fraatjan	ɸraatjan
atta	atːa
atwitains	atwɪtɛns
Aþeinim	aθinɪm
aþnam	aθnam
aþþan	aθːan
audagei	ɔðaɣi
audagjan	ɔðaɣjan
audags	ɔðaɣs
audahafts	ɔðahaɸts
aufto	ɔɸto
augadauro	ɔɣaðɔro
augjan	ɔɣjan
ataugjan	atɔɣjan
augo	ɔɣo
auhjodus	ɔhjoðus
auhjon	ɔhjon
auhns	ɔhn̥s
auhsa	ɔhsa
auhsus	ɔhsus
auhuma	ɔhuma
auhumists	ɔhumɪsts
auk	ɔk
aukan	ɔkan
anaaukan	anaɔkan
biaukan	bɪɔkan
gaaukan	ɡaɔkan
auknan	ɔknan
biauknan	bɪɔknan
Auneiseifaurus	ɔnisiɸɔrus
Aunisimus	ɔnɪsɪmus
aurahjom	ɔrahjom
aurali	ɔralɪ
aurkjus	ɔrkjus
aurkeis	ɔrkis
aurtigards	ɔrtɪɣards
aurtja	ɔrtja
auso	ɔso
auþida	ɔθɪða
auþeis	ɔθis
auþs	ɔθs
aweþi	aweθɪ
awiliudon	awɪlɪuðon
awiliuþ	awɪlɪuθ
awistr	awɪstr̥
awo	awo
Axaïa	aχɛ̈a
azetjam	azetjam
azets	azets
azgo	azɡo
azwme	azwme
ba	ba
Babawis	baβawɪs
badi	baðɪ
Bagauis	baɣɔɪs
bagms	baɣm̥s
bai	bɛ
Baiailzaibul	bɛɛlzɛβul
baidjan	bɛðjan
gabaidjan	ɡaβɛðjan
Baidsaiïdan	bɛðsɛɪ̈ðan
Bailiam	bɛlɪam
Bainiamein	bɛnɪamin
bairabagms	bɛraβaɣm̥s
bairan	bɛran
atbairan	atbɛran
innatbairan	ɪnːatbɛran
frabairan	ɸraβɛran
gabairan	ɡaβɛran
þairhbairan	θɛrhbɛran
usbairan	usbɛran
ūtbairan	utbɛran
Bairauja	bɛrɔja
bairgahei	bɛrɡahi
bairgan	bɛrɡan
gabairgan	ɡaβɛrɡan
bairhtei	bɛrhti
bairhtjan	bɛrhtjan
gabairhtjan	ɡaβɛrhtjan
bairhts	bɛrhts
bairhtaba	bɛrhtaβa
baitrei	bɛtri
baitrs	bɛtr̥s
Baiþil	bɛθɪl
Baiþlaem	bɛθlaem
Baiþsaïdan	bɛθsɛ̈ðan
bajoþs	bajoθs
balgs	balɡs
balsagga	balsaŋɡa
balsan	balsan
balþaba	balθaβa
balþei	balθi
balþjan	balθjan
balwawesei	balwawesi
balweins	balwins
balwjan	balwjan
Banauis	banɔɪs
bandi	bandɪ
bandja	bandja
bandwa	bandwa
bandwjan	bandwjan
gabandwjan	ɡaβandwjan
bandwo	bandwo
banja	banja
bansts	bansts
Barabba	barabːa
Barakeias	barakias
barbarus	barbarus
barizeins	barɪzins
barms	barm̥s
barn	barn̥
Barnabas	barnaβas
barnilo	barnɪlo
barniskei	barnɪski
barniski	barnɪskɪ
barnisks	barnɪsks
Barteimaiaus	bartimɛɔs
Barþaulaumaius	barθɔlɔmɛus
barusnjan	barusnjan
Bassus	basːus
batiza	batɪza
batista	batɪsta
gabatnan	ɡaβatnan
Batwins	batwɪns
bauains	bɔɛns
bauan	bɔan
gabauan	ɡaβɔan
Bauanairgais	bɔanɛrɡɛs
Bauauz	bɔɔz
usbaugjan	usbɔɣjan
ufbauljan	uɸbɔljan
baur	bɔr
baurgja	bɔrɡja
baurgs	bɔrɡs
baurgswaddjus	bɔrɡswadːjus
baurþei	bɔrθi
bauþs	bɔθs
beidan	biðan
gabeidan	ɡaβiðan
usbeidan	usbiðan
beist	bist
gabeistjan	ɡaβistjan
beitan	bitan
andbeitan	andbitan
Beroþ	beroθ
berusjos	berusjos
Beþania	beθanɪa
Beþlaihaim	beθlɛhɛm
Beþsaeida	beθsaiða
Beþsfagei	beθsɸaɣi
bi	bɪ
bibaurgeins	bɪβɔrɡins
bida	bɪða
bidagwa	bɪðaɣwa
bidjan	bɪðjan
gabidjan	ɡaβɪðjan
usbidan	usbɪðan
bifaih	bɪɸɛh
bifaihon	bɪɸɛhon
bihait	bɪhɛt
bihaitja	bɪhɛtja
biƕe	bɪʍe
bijands	bɪjands
bimait	bɪmɛt
bindan	bɪndan
andbindan	andbɪndan
bibindan	bɪβɪndan
gabindan	ɡaβɪndan
bireikei	bɪriki
birekjai	bɪrekjɛ
birodeins	bɪroðins
birūnains	bɪrunɛns
birusjos	bɪrusjos
bisauleins	bɪsɔlins
bistugq	bɪstuŋkʷ
bisunjane	bɪsunjane
biþe	bɪθe
anabiudan	anaβɪuðan
faurbiudan	ɸɔrbɪuðan
biugan	bɪuɣan
gabiugan	ɡaβɪuɣan
biuhti	bɪuhtɪ
biuhts	bɪuhts
biuþs	bɪuθs
blandan	blandan
blauþjan	blɔθjan
gablauþjan	ɡaβlɔθjan
bleiþei	bliθi
bleiþjan	bliθjan
gableiþjan	ɡaβliθjan
bleiþs	bliθs
ufblesan	uɸblesan
bliggwan	blɪɡɡwan
usbliggwan	usblɪɡɡwan
gablindjan	ɡaβlɪndjan
afblindnan	aɸblɪndnan
blinds	blɪnds
bloma	bloma
blotan	blotan
blotinassus	blotɪnasːus
bloþ	bloθ
bloþarinnandei	bloθarɪnːandi
bnauan	bnɔan
boka	boka
bokareis	bokaris
bota	bota
botjan	botjan
gabotjan	ɡaβotjan
braƕa	braʍa
braidei	brɛði
usbraidjan	usbrɛðjan
braiþs	brɛθs
brakja	brakja
gabrannjan	ɡaβranːjan
inbrannjan	ɪnbranːjan
briggan	brɪŋɡan
brikan	brɪkan
gabrikan	ɡaβrɪkan
ufbrikan	uɸbrɪkan
brinnan	brɪnːan
ufbrinnan	uɸbrɪnːan
brinno	brɪnːo
broþar	broθar
broþrahans	broθrahans
broþrulubo	broθruluβo
brūkjan	brukjan
usbruknan	usbruknan
brūks	bruks
brunjo	brunjo
brunna	brunːa
brusts	brusts
brūþfaþs	bruθɸaθs
brūþs	bruθs
bugjan	buɣjan
frabugjan	ɸraβuɣjan
usbugjan	usbuɣjan
andbundnan	andbundnan
bwssaun	bwsːɔn
gadaban	ɡaðaβan
daddjan	dadːjan
dags	daɣs
daigs	dɛɣs
Daikapaulis	dɛkapɔlɪs
daila	dɛla
dailjan	dɛljan
afdailjan	aɸdɛljan
disdailjan	dɪsdɛljan
fradailjan	ɸraðɛljan
gadailjan	ɡaðɛljan
dails	dɛls
daimonareis	dɛmonaris
dals	dals
dalaþ	dalaθ
dalaþa	dalaθa
dalaþro	dalaθro
Dalmatia	dalmatɪa
Damaskon	damaskon
faurdammjan	ɸɔrdamːjan
daubei	dɔβi
daubiþa	dɔβɪθa
gadaubjan	ɡaðɔβjan
afdaubnan	aɸdɔβnan
usdaudjan	usdɔðjan
daufs	dɔɸs
dauhtar	dɔhtar
dauhts	dɔhts
afdauiþs	aɸdɔɪθs
dauns	dɔns
daupeins	dɔpins
daupjan	dɔpjan
ufdaupjan	uɸdɔpjan
daupjands	dɔpjands
daur	dɔr
daurawarda	dɔrawarda
daurawardo	dɔrawardo
daurawards	dɔrawards
Dauriþaius	dɔrɪθɛus
daurons	dɔrons
gadaursan	ɡaðɔrsan
dauþeins	dɔθins
dauþjan	dɔθjan
afdauþjan	aɸdɔθjan
gadauþjan	ɡaðɔθjan
gadauþnan	ɡaðɔθnan
miþgadauþnan	mɪθɡaðɔθnan
dauþs	dɔθs
dauþubleis	dɔθuβlis
dauþus	dɔθus
Daweid	dawið
Demas	demas
diabula	dɪaβula
diabaulus	dɪaβɔlus
diabulus	dɪaβulus
diakaunus	dɪakɔnus
Didimus	dɪðɪmus
digan	dɪɣan
gadigan	ɡaðɪɣan
digrei	dɪɣri
distaheins	dɪstahins
diswiss	dɪswɪsː
diupei	dɪupi
diupiþa	dɪupɪθa
gadiupjan	ɡaðɪupjan
diups	dɪups
dius	dɪus
diwan	dɪwan
afdobnan	aɸdoβnan
afdojan	aɸdojan
domjan	domjan
afdomjan	aɸdomjan
bidomjan	bɪðomjan
gadomjan	ɡaðomjan
doms	doms
gadraban	ɡaðraβan
dragan	draɣan
gadragan	ɡaðraɣan
dragk	draŋk
dragkjan	draŋkjan
gadragkjan	ɡaðraŋkjan
draibjan	drɛβjan
drakma	drakma
drauhsnos	drɔhsnos
drauhtinassus	drɔhtɪnasːus
drauhtinon	drɔhtɪnon
drauhtiwitoþ	drɔhtɪwɪtoθ
afdrausjan	aɸdrɔsjan
gadrausjan	ɡaðrɔsjan
drausnos	drɔsnos
dreiban	driβan
usdreiban	usdriβan
drigkan	drɪŋkan
anadrigkan	anaðrɪŋkan
gadrigkan	ɡaðrɪŋkan
driugan	drɪuɣan
driusan	drɪusan
atdriusan	atdrɪusan
disdriusan	dɪsdrɪusan
gadriusan	ɡaðrɪusan
usdriusan	usdrɪusan
driuso	drɪuso
drobjan	droβjan
drobna	droβna
drobnan	droβnan
gadrobnan	ɡaðroβnan
indrobnan	ɪndroβnan
drugkanei	druŋkani
drunjus	drunjus
drus	drus
du	du
dugan	duɣan
duƕe	duʍe
dulgahaitja	dulɡahɛtja
dulgis	dulɡɪs
dulþjan	dulθjan
dulþs	dulθs
afdumbnan	aɸdumbnan
dumbs	dumbs
duþe	duθe
dwalawaurdei	dwalawɔrdi
dwaliþa	dwalɪθa
dwalmon	dwalmon
dwals	dwals
Eeiram	eiram
ei	i
Eiaireiko	iɛriko
Eikaunion	ikɔnɪon
eisarn	isarn̥
eisarnabandi	isarnaβandɪ
eisarneins	isarnins
eiþan	iθan
eiþau	iθɔ
Esaïas	esɛ̈as
Esaw	esaw
fadar	ɸaðar
Faddasur	ɸadːasur
fadrein	ɸaðrin
fadreins	ɸaðrins
faginon	ɸaɣɪnon
miþfaginon	mɪθɸaɣɪnon
fagrs	ɸaɣr̥s
fāhan	ɸahan
gafahan	ɡaɸahan
faheþs	ɸaheθs
fullafahjan	ɸulːaɸahjan
gafahrjan	ɡaɸahrjan
faian	ɸɛan
bifaihon	bɪɸɛhon
gafaihon	ɡaɸɛhon
faihu	ɸɛhu
faihufrikei	ɸɛhuɸrɪki
faihufriks	ɸɛhuɸrɪks
faihugairnei	ɸɛhuɣɛrni
faihugairns	ɸɛhuɣɛrn̥s
faihugawaurki	ɸɛhuɣawɔrkɪ
faihugeiro	ɸɛhuɣiro
faihuskula	ɸɛhuskula
faihuþraihna	ɸɛhuθrɛhna
fairguni	ɸɛrɡunɪ
waifairƕjan	wɛɸɛrʍjan
fairƕus	ɸɛrʍus
fairina	ɸɛrɪna
fairinon	ɸɛrɪnon
fairneis	ɸɛrnis
fairniþa	ɸɛrnɪθa
fairns	ɸɛrn̥s
fairra	ɸɛrːa
fairraþro	ɸɛrːaθro
fairweitl	ɸɛrwitl̥
fairzna	ɸɛrzna
Falaig	ɸalɛɣ
Fallasur	ɸalːasur
falþan	ɸalθan
fana	ɸana
fani	ɸanɪ
Fanuel	ɸanuel
Farais	ɸarɛs
faran	ɸaran
Farao	ɸarao
Fareisaius	ɸarisɛus
farjan	ɸarjan
atfarjan	atɸarjan
fāskja	ɸaskja
fastan	ɸastan
gafastan	ɡaɸastan
fastubni	ɸastuβnɪ
faþa	ɸaθa
fauho	ɸɔho
faur	ɸɔr
faura	ɸɔra
fauradauri	ɸɔraðɔrɪ
faurafilli	ɸɔraɸɪlːɪ
fauragagga	ɸɔraɣaŋɡa
fauragaggi	ɸɔraɣaŋɡɪ
fauragaggja	ɸɔraɣaŋɡja
faurahāh	ɸɔrahah
fauramaþleis	ɸɔramaθlis
fauramaþli	ɸɔramaθlɪ
fauratani	ɸɔratanɪ
faurbauhts	ɸɔrbɔhts
faurdomeins	ɸɔrdomins
faurhāh	ɸɔrhah
faurhtei	ɸɔrhti
faurhtjan	ɸɔrhtjan
faurhts	ɸɔrhts
faurlageins	ɸɔrlaɣins
faurstasseis	ɸɔrstasːis
Faurtunatus	ɸɔrtunatus
faurþis	ɸɔrθɪs
faurþizei	ɸɔrθɪzi
fawai	ɸawɛ
infeinan	ɪnɸinan
fera	ɸera
ferja	ɸerja
fetjan	ɸetjan
fian	ɸɪan
fidurdogs	ɸɪðurdoɣs
fidurfalþs	ɸɪðurɸalθs
fidurragini	ɸɪðurːaɣɪnɪ
fidwor	ɸɪðwor
fidwortaihun	ɸɪðwortɛhun
figgragulþ	ɸɪŋɡraɣulθ
figgrs	ɸɪŋɡr̥s
fijan	ɸɪjan
fijands	ɸɪjands
fijaþwa	ɸɪjaθwa
filaus	ɸɪlɔs
filegri	ɸɪleɣrɪ
Filetus	ɸɪletus
filhan	ɸɪlhan
affilhan	aɸːɪlhan
anafilhan	anaɸɪlhan
gafilhan	ɡaɸɪlhan
usfilhan	usɸɪlhan
filigri	ɸɪlɪɣrɪ
Filippai	ɸɪlɪpːɛ
Filippisius	ɸɪlɪpːɪsɪus
Filippus	ɸɪlɪpːus
filleins	ɸɪlːins
filu	ɸɪlu
filudeisei	ɸɪluðisi
filufáihs	ɸɪluɸɛhs
filugalaufs	ɸɪluɣalɔɸs
filusna	ɸɪlusna
filuwaurdei	ɸɪluwɔrdi
filuwaurdjan	ɸɪluwɔrdjan
fimf	ɸɪmɸ
fimftaihun	ɸɪmɸtɛhun
fimftataihunda	ɸɪmɸtatɛhunda
finþan	ɸɪnθan
fiskja	ɸɪskja
fiskon	ɸɪskon
fisks	ɸɪsks
fitan	ɸɪtan
flahtom	ɸlahtom
usflaugjan	usɸlɔɣjan
flautjan	ɸlɔtjan
flauts	ɸlɔts
flodus	ɸloðus
flokan	ɸlokan
fodeins	ɸoðins
fodjan	ɸoðjan
fodr	ɸoðr̥
fon	ɸon
fotubandi	ɸotuβandɪ
fotubaurd	ɸotuβɔrd
fotus	ɸotus
frabauhtaboka	ɸraβɔhtaβoka
fragan	ɸraɣan
fragifts	ɸraɣɪɸts
fraihnan	ɸrɛhnan
gafraihnan	ɡaɸrɛhnan
fraisan	ɸrɛsan
usfraisan	usɸrɛsan
fraistubni	ɸrɛstuβnɪ
fraiw	ɸrɛw
fralet	ɸralet
fralets	ɸralets
fralusts	ɸralusts
fram	ɸram
framaldrs	ɸramaldr̥s
framaþeis	ɸramaθis
framaþjan	ɸramaθjan
framgāhts	ɸramɡahts
framis	ɸramɪs
framwairþis	ɸramwɛrθɪs
framwigis	ɸramwɪɣɪs
fraqisteins	ɸrakʷɪstins
frastisibja	ɸrastɪsɪβja
frasts	ɸrasts
usfratwjan	usɸratwjan
fraþi	ɸraθɪ
fraþjamarzeins	ɸraθjamarzins
fraþjan	ɸraθjan
fullafraþjan	ɸulːaɸraθjan
frauja	ɸrɔja
fraujinassus	ɸrɔjɪnasːus
fraujinon	ɸrɔjɪnon
gafraujinon	ɡaɸrɔjɪnon
fraujinonds	ɸrɔjɪnonds
frawardeins	ɸrawardins
frawaurhts	ɸrawɔrhts
frawaurhts	ɸrawɔrhts
fraweit	ɸrawit
freidjan	ɸriðjan
freihals	ɸrihals
freis	ɸris
friaþwamildjai	ɸrɪaθwamɪldjɛ
frijaþwa	ɸrɪjaθwa
frijei	ɸrɪji
frijon	ɸrɪjon
frijondi	ɸrɪjondɪ
frijonds	ɸrɪjonds
frijons	ɸrɪjons
gafrisahtjan	ɡaɸrɪsahtjan
gafrisahtnan	ɡaɸrɪsahtnan
frisahts	ɸrɪsahts
Friþareikeis	ɸrɪθarikis
gafriþon	ɡaɸrɪθon
friusa	ɸrɪusa
frodei	ɸroði
froþs	ɸroθs
fruma	ɸruma
frumabaur	ɸrumaβɔr
frumadei	ɸrumaði
frumisti	ɸrumɪstɪ
frumists	ɸrumɪsts
frumist	ɸrumɪst
fugls	ɸuɣl̥s
fula	ɸula
fulgins	ɸulɡɪns
fulhsni	ɸulhsnɪ
fullafahjan	ɸulːaɸahjan
fullafraþjan	ɸulːaɸraθjan
fullatojis	ɸulːatojɪs
fullaweis	ɸulːawis
fullaweisjan	ɸulːawisjan
fullawita	ɸulːawɪta
fulleiþ	ɸulːiθ
fulljan	ɸulːjan
gafulljan	ɡaɸulːjan
ufarfulljan	uɸarɸulːjan
usfulljan	usɸulːjan
fullnan	ɸulːnan
gafullnan	ɡaɸulːnan
usfullnan	usɸulːnan
fullo	ɸulːo
fulls	ɸulːs
fūls	ɸuls
funins	ɸunɪns
funisks	ɸunɪsks
Fwgailus	ɸwɡɛlus
fwnikisks	ɸwnɪkɪsks
gaaggwei	ɡaaɡɡwi
gaarbja	ɡaarbja
Gabaa	ɡaβaa
Gabair	ɡaβɛr
gabairhteins	ɡaβɛrhtins
gabaur	ɡaβɔr
gabaur	ɡaβɔr
gabaurgja	ɡaβɔrɡja
gabaurjaba	ɡaβɔrjaβa
gabaurjoþus	ɡaβɔrjoθus
gabaurþiwaurd	ɡaβɔrθɪwɔrd
gabaurþs	ɡaβɔrθs
gabei	ɡaβi
gabeigs	ɡaβiɣs
gabigjan	ɡaβɪɣjan
gabignan	ɡaβɪɣnan
gabigs	ɡaβɪɣs
gabigaba	ɡaβɪɣaβa
gabinda	ɡaβɪnda
gabindi	ɡaβɪndɪ
gableiþeins	ɡaβliθins
Gabriel	ɡaβrɪel
gabruka	ɡaβruka
gabundi	ɡaβundɪ
gadaila	ɡaðɛla
gadauka	ɡaðɔka
Gaddarenus	ɡadːarenus
gadeþs	ɡaðeθs
gadigis	ɡaðɪɣɪs
gadiliggs	ɡaðɪlɪŋɡs
gadofs	ɡaðoɸs
gadrauhts	ɡaðrɔhts
gafāh	ɡaɸah
gafaurds	ɡaɸɔrds
gafaurs	ɡaɸɔrs
gafehaba	ɡaɸehaβa
gafeteins	ɡaɸetins
gafilh	ɡaɸɪlh
gafraþjei	ɡaɸraθji
gafreideins	ɡaɸriðins
gafrijons	ɡaɸrɪjons
gafriþons	ɡaɸrɪθons
gafulgins	ɡaɸulɡɪns
gagg	ɡaŋɡ
gaggan	ɡaŋɡan
afgaggan	aɸɡaŋɡan
afargaggan	aɸarɡaŋɡan
anagaggan	anaɣaŋɡan
atgaggan	atɡaŋɡan
duatgaggan	duatɡaŋɡan
innatgaggan	ɪnːatɡaŋɡan
faurgaggan	ɸɔrɡaŋɡan
faurbigaggan	ɸɔrbɪɣaŋɡan
fauragaggan	ɸɔraɣaŋɡan
gagaggan	ɡaɣaŋɡan
inngaggan	ɪnːɣaŋɡan
miþgaggan	mɪθɡaŋɡan
þairhgaggan	θɛrhɡaŋɡan
ufargaggan	uɸarɡaŋɡan
usgaggan	usɡaŋɡan
ūtgaggan	utɡaŋɡan
wiþragaggan	wɪθraɣaŋɡan
gagrefts	ɡaɣreɸts
gagudei	ɡaɣuði
gaguþs	ɡaɣuθs
gagudaba	ɡaɣuðaβa
gahāhjo	ɡahahjo
gahails	ɡahɛls
gahait	ɡahɛt
gahauseins	ɡahɔsins
gahlaiba	ɡahlɛβa
gahlaifs	ɡahlɛɸs
gahnipnan	ɡahnɪpnan
gahobains	ɡahoβɛns
gahraineins	ɡahrɛnins
gahugds	ɡahuɣds
gaƕairbs	ɡaʍɛrbs
gaƕeilains	ɡaʍilɛns
gaiainna	ɡɛɛnːa
gaidw	ɡɛðw
gailjan	ɡɛljan
Gainnesaraiþ	ɡɛnːesarɛθ
gairda	ɡɛrda
bigairdan	bɪɣɛrdan
ufgairdan	uɸɡɛrdan
Gairgaisainus	ɡɛrɡɛsɛnus
gairnei	ɡɛrni
gairnjan	ɡɛrnjan
gairuni	ɡɛrunɪ
usgaisjan	usɡɛsjan
gaitein	ɡɛtin
gaits	ɡɛts
Gaïus	ɡɛ̈us
gajuk	ɡajuk
gajuka	ɡajuka
gajuko	ɡajuko
gakunds	ɡakunds
gakunþs	ɡakunθs
gakusts	ɡakusts
galaista	ɡalɛsta
Galateis	ɡalatis
Galatia	ɡalatɪa
galaubeins	ɡalɔβins
galaubeins	ɡalɔβins
galaufs	ɡalɔɸs
galeika	ɡalika
galeiki	ɡalikɪ
galeiks	ɡaliks
galeiko	ɡaliko
Galeilaia	ɡalilɛa
Galeilaius	ɡalilɛus
galga	ɡalɡa
galigri	ɡalɪɣrɪ
galiug	ɡalɪuɣ
galiugaapaustaulus	ɡalɪuɣaapɔstɔlus
galiugabroþar	ɡalɪuɣaβroθar
galiugaguþ	ɡalɪuɣaɣuθ
galiugapraufetus	ɡalɪuɣaprɔɸetus
galiugaweitwoþs	ɡalɪuɣawitwoθs
galiugaxristus	ɡalɪuɣaχrɪstus
galubaim	ɡaluβɛm
gamaindūþs	ɡamɛnduθs
gamainei	ɡamɛni
gamainja	ɡamɛnja
gamains	ɡamɛns
gamainþs	ɡamɛnθs
gamaiþs	ɡamɛθs
gamalteins	ɡamaltins
gaman	ɡaman
gamarko	ɡamarko
gamarzeins	ɡamarzins
gamaudeins	ɡamɔðins
gameleins	ɡamelins
gaminþi	ɡamɪnθɪ
gamitons	ɡamɪtons
gamunds	ɡamunds
ganauha	ɡanɔha
ganists	ɡanɪsts
ganiþjis	ɡanɪθjɪs
ganohs	ɡanohs
gansjan	ɡansjan
gaqiss	ɡakʷɪsː
gaqiss	ɡakʷɪsː
gaqumþs	ɡakʷumθs
garaideins	ɡarɛðins
garaihtei	ɡarɛhti
garaihteins	ɡarɛhtins
garaihtiþa	ɡarɛhtɪθa
garaihts	ɡarɛhts
garaiþs	ɡarɛθs
garazna	ɡarazna
garazno	ɡarazno
garda	ɡarda
gardawaldands	ɡardawaldands
gards	ɡards
garedaba	ɡareðaβa
garehsns	ɡarehsn̥s
gariudei	ɡarɪuði
gariudi	ɡarɪuðɪ
gariuþs	ɡarɪuθs
garūni	ɡarunɪ
garunjo	ɡarunjo
garuns	ɡaruns
gasahts	ɡasahts
gasateins	ɡasatins
gasinþa	ɡasɪnθa
gasinþja	ɡasɪnθja
gaskadweins	ɡaskaðwins
gaskafts	ɡaskaɸts
gaskaideins	ɡaskɛðins
gaskalki	ɡaskalkɪ
gaskohi	ɡaskohɪ
gaskohs	ɡaskohs
gastigodei	ɡastɪɣoði
gastigoþs	ɡastɪɣoθs
gasts	ɡasts
gataura	ɡatɔra
gataurþs	ɡatɔrθs
gatemiba	ɡatemɪβa
gatils	ɡatɪls
gatilaba	ɡatɪlaβa
gatimreins	ɡatɪmrins
gatimrjo	ɡatɪmrjo
gatwo	ɡatwo
gaþagki	ɡaθaŋkɪ
gaþaurbs	ɡaθɔrbs
gaþlaihts	ɡaθlɛhts
gaþrafsteins	ɡaθraɸstins
gaþrask	ɡaθrask
gauja	ɡɔja
Gaulgauþa	ɡɔlɡɔθa
Gaumaurra	ɡɔmɔrːa
Gaumaurjam	ɡɔmɔrjam
gaumjan	ɡɔmjan
gaunon	ɡɔnon
gaunoþus	ɡɔnoθus
gaurei	ɡɔri
gauriþa	ɡɔrɪθa
gaurjan	ɡɔrjan
gáurs	ɡɔrs
gawairþeigs	ɡawɛrθiɣs
gawairþi	ɡawɛrθɪ
gawaleins	ɡawalins
gawamms	ɡawamːs
gawandeins	ɡawandins
gawargeins	ɡawarɡins
gawaseins	ɡawasins
gawaurdi	ɡawɔrdɪ
gawaurki	ɡawɔrkɪ
gawaurstwa	ɡawɔrstwa
gawaurts	ɡawɔrts
gawi	ɡawɪ
gawiljis	ɡawɪljɪs
gawiss	ɡawɪsː
gawizneigs	ɡawɪzniɣs
gazaufwlakio	ɡazɔɸwlakɪo
gazds	ɡazds
faihugeigan	ɸɛhuɣiɣan
gageigan	ɡaɣiɣan
usgeisnan	usɡisnan
giba	ɡɪβa
giban	ɡɪβan
gibands	ɡɪβands
afgiban_sik	aɸɡɪβan_sɪk
atgiban	atɡɪβan
fragiban	ɸraɣɪβan
usgiban	usɡɪβan
gibla	ɡɪβla
gild	ɡɪld
fragildan	ɸraɣɪldan
usgildan	usɡɪldan
gilstr	ɡɪlstr̥
gilstrameleins	ɡɪlstramelins
gilþa	ɡɪlθa
duginnan	duɣɪnːan
gistradagis	ɡɪstraðaɣɪs
bigitan	bɪɣɪtan
giutan	ɡɪutan
ufargiutan	uɸarɡɪutan
glaggwaba	ɡlaɡɡwaβa
glaggwo	ɡlaɡɡwo
glaggwuba	ɡlaɡɡwuβa
glitmunjan	ɡlɪtmunjan
godakunds	ɡoðakunds
godei	ɡoði
goleins	ɡolins
goljan	ɡoljan
goþs	ɡoθs
graba	ɡraβa
graban	ɡraβan
bigraban	bɪɣraβan
ufgraban	uɸɡraβan
usgraban	usɡraβan
gramjan	ɡramjan
ingramjan	ɪnɡramjan
gramsta	ɡramsta
gras	ɡras
gredags	ɡreðaɣs
gredon	ɡreðon
gredus	ɡreðus
greipan	ɡripan
fairgreipan	ɸɛrɡripan
undgreipan	undɡripan
gretan	ɡretan
grets	ɡrets
grindafraþjis	ɡrɪndaɸraθjɪs
griþs	ɡrɪθs
groba	ɡroβa
grunduwaddjus	ɡrunduwadːjus
gudafaurhts	ɡuðaɸɔrhts
gudalaus	ɡuðalɔs
gudaskaunei	ɡuðaskɔni
gudblostreis	ɡuðblostris
gudhūs	ɡuðhus
Gudilub	ɡuðɪluβ
gudisks	ɡuðɪsks
gudja	ɡuðja
gudjinassus	ɡuðjɪnasːus
gudjinon	ɡuðjɪnon
gulþ	ɡulθ
gulþeins	ɡulθins
guma	ɡuma
gumakunds	ɡumakunds
gumein	ɡumin
gund	ɡund
usgutnan	usɡutnan
Gutþiuda	ɡutθɪuða
guþ	ɡuθ
haban	haβan
afhaban	aɸhaβan
anahaban	anahaβan
athaban	athaβan
dishaban	dɪshaβan
gahaban	ɡahaβan
ufhaban	uɸhaβan
hafjan	haɸjan
andhafjan	andhaɸjan
athafjan	athaɸjan
ufarhafjan	uɸarhaɸjan
ushafjan	ushaɸjan
ufarhafnan	uɸarhaɸnan
haftjan	haɸtjan
gahaftjan	ɡahaɸtjan
gagáhaftjan	ɡaɣahaɸtjan
gahaftnan	ɡahaɸtnan
hafts	haɸts
hāhan	hahan
athahan	athahan
ushahan	ushahan
hāhan	hahan
Haibraius	hɛβrɛus
haidus	hɛðus
haifstjan	hɛɸstjan
haifsts	hɛɸsts
háihs	hɛhs
Haileias	hɛlias
Haileisaius	hɛlisɛus
hailjan	hɛljan
gahailjan	ɡahɛljan
gahailnan	ɡahɛlnan
hails	hɛls
haimoþli	hɛmoθlɪ
haims	hɛms
hairaiseis	hɛrɛsis
hairda	hɛrda
hairdeis	hɛrdis
Hairmaugaineis	hɛrmɔɣɛnis
Hairodia	hɛroðɪa
hairto	hɛrto
hairþra	hɛrθra
hairus	hɛrus
haizam	hɛzam
haitan	hɛtan
anahaitan	anahɛtan
andhaitan	andhɛtan
athaitan	athɛtan
fairhaitan	ɸɛrhɛtan
gahaitan	ɡahɛtan
fauragahaitan	ɸɔraɣahɛtan
ushaitan	ushɛtan
haiti	hɛtɪ
haiþi	hɛθɪ
haiþiwisks	hɛθɪwɪsks
háiþno	hɛθno
hakuls	hakuls
halba	halba
halbs	halbs
haldan	haldan
haldis	haldɪs
halisaiw	halɪsɛw
halja	halja
halks	halks
hallus	halːus
hals	hals
halsagga	halsaŋɡa
halts	halts
hamfs	hamɸs
afhamon	aɸhamon
anahamon	anahamon
andhamon	andhamon
gahamon	ɡahamon
ufarhamon	uɸarhamon
hana	hana
handugei	handuɣi
handugs	handuɣs
handus	handus
handuwaurhts	handuwɔrhts
hansa	hansa
gahardjan	ɡahardjan
harduhairtei	harduhɛrti
hardus	hardus
harjis	harjɪs
hatan	hatan
hatis	hatɪs
hatizon	hatɪzon
hatjan	hatjan
haubiþ	hɔβɪθ
hauhei	hɔhi
hauheins	hɔhins
hauhhairtei	hɔhhɛrti
hauhhairts	hɔhhɛrts
hauhisti	hɔhɪstɪ
hauhiþa	hɔhɪθa
hauhjan	hɔhjan
ufarhauhjan	uɸarhɔhjan
ushauhjan	ushɔhjan
ushauhnan	ushɔhnan
háuhs	hɔhs
hauhista	hɔhɪsta
hauhaba	hɔhaβa
hauhis	hɔhɪs
hauhþuhts	hɔhθuhts
hauneins	hɔnins
hauniþa	hɔnɪθa
haunjan	hɔnjan
gahaunjan	ɡahɔnjan
hauns	hɔns
haurds	hɔrds
hauri	hɔrɪ
haurn	hɔrn̥
haurnja	hɔrnja
haurnjan	hɔrnjan
hauseins	hɔsins
hausjan	hɔsjan
andhausjan	andhɔsjan
gahausjan	ɡahɔsjan
ufhausjan	uɸhɔsjan
hausjon	hɔsjon
hawi	hawɪ
hazeins	hazins
hazjan	hazjan
heito	hito
heiwafrauja	hiwaɸrɔja
helei	heli
Helei	heli
Helias	helɪas
Her	her
her	her
Herodes	heroðes
Herodia	heroðɪa
Herodianus	heroðɪanus
heþjo	heθjo
hi	hɪ
hidre	hɪðre
hilms	hɪlm̥s
hilpan	hɪlpan
gahilpan	ɡahɪlpan
himinakunds	hɪmɪnakunds
himins	hɪmɪns
himma	hɪmːa
hindana	hɪndana
hindar	hɪndar
hindarweis	hɪndarwis
hindarweisei	hɪndarwisi
hindumists	hɪndumɪsts
frahinþan	ɸrahɪnθan
miþfrahinþan	mɪθɸrahɪnθan
ushinþan	ushɪnθan
hiri	hɪrɪ
hita	hɪta
hiufan	hɪuɸan
hiuhma	hɪuhma
hiwi	hɪwɪ
hlahjan	hlahjan
bihlahjan	bɪhlahjan
hlaifs	hlɛɸs
hlaine	hlɛne
hlaiw	hlɛw
hlaiwasnos	hlɛwasnos
hlamma	hlamːa
hlas	hlas
hlasoza	hlasoza
hlasei	hlasi
afhlaþan	aɸhlaθan
ushlaupan	ushlɔpan
hlauts	hlɔts
hleibjan	hliβjan
hleiduma	hliðuma
hleiþra	hliθra
ufarhleiþrjan	uɸarhliθrjan
hleþrastakeins	hleθrastakins
hlifan	hlɪɸan
hliftus	hlɪɸtus
hlijans	hlɪjans
hliuma	hlɪuma
ufhlohjan	uɸhlohjan
hlutrei	hlutri
hlutriþa	hlutrɪθa
hlūtrs	hlutr̥s
hnaiweins	hnɛwins
hnaiwjan	hnɛwjan
anahnaiwjan	anahnɛwjan
gahnaiwjan	ɡahnɛwjan
ufhnaiwjan	uɸhnɛwjan
hnaiws	hnɛws
hnasqjaim	hnaskʷjɛm
hneiwan	hniwan
anahneiwan	anahniwan
gahnipnan	ɡahnɪpnan
dishniupan	dɪshnɪupan
dishnupnan	dɪshnupnan
hnuþo	hnuθo
hoha	hoha
holon	holon
afholon	aɸholon
horinassus	horɪnasːus
horinon	horɪnon
gahorinon	ɡahorɪnon
hors	hors
hrainei	hrɛni
hraineins	hrɛnins
hrainjahairts	hrɛnjahɛrts
hrainjan	hrɛnjan
afhrainjan	aɸhrɛnjan
gahrainjan	ɡahrɛnjan
ushrainjan	ushrɛnjan
hrains	hrɛns
hraiwadūbo	hrɛwaðuβo
hramjan	hramjan
ushramjan	ushramjan
afhrisjan	aɸhrɪsjan
ushrisjan	ushrɪsjan
hropjan	hropjan
ufhropjan	uɸhropjan
hrops	hrops
hrot	hrot
hroþeigs	hroθiɣs
hrugga	hruŋɡa
hrūkjan	hrukjan
hruk	hruk
andhruskan	andhruskan
huggrjan	huŋɡrjan
hugjan	huɣjan
afhugjan	aɸhuɣjan
andhugjan	andhuɣjan
fauragahugjan	ɸɔraɣahuɣjan
ufarhugjan	uɸarhuɣjan
hugs	huɣs
hugs	huɣs
huhjan	huhjan
huhrus	huhrus
hulistr	hulɪstr̥
huljan	huljan
andhuljan	andhuljan
dishuljan	dɪshuljan
gahuljan	ɡahuljan
ushulon	ushulon
hulþs	hulθs
hulundi	hulundɪ
hun	hun
hunda	hunda
hundafaþs	hundaɸaθs
hunds	hunds
hunsl	hunsl̥
hunslastaþs	hunslastaθs
hunsljan	hunsljan
hunþs	hunθs
hups	hups
huzd	huzd
huzdjan	huzdjan
Hwmainaius	hwmɛnɛus
hwssopon	hwsːopon
ƕad	ʍað
ƕadre	ʍaðre
ƕah	ʍah
ƕairban	ʍɛrban
biƕairban	bɪʍɛrban
ƕairnei	ʍɛrni
ƕaiteis	ʍɛtis
ƕaiwa	ʍɛwa
ƕan	ʍan
ƕanhun	ʍanhun
afƕapjan	aɸʍapjan
afƕapnan	aɸʍapnan
ƕar	ʍar
ƕarbon	ʍarbon
ƕarjis	ʍarjɪs
ƕarjizuh	ʍarjɪzuh
ƕas	ʍas
ƕashun	ʍashun
ƕassaba	ʍasːaβa
ƕassei	ʍasːi
gaƕatjan	ɡaʍatjan
ƕaþ	ʍaθ
ƕaþar	ʍaθar
ƕaþaruh	ʍaθaruh
ƕaþjan	ʍaθjan
ƕaþo	ʍaθo
ƕaþro	ʍaθro
ƕazuh	ʍazuh
ƕe	ʍe
ƕeh	ʍeh
ƕeila	ʍila
ƕeilaƕairbs	ʍilaʍɛrbs
ƕeilan	ʍilan
anaƕeilan	anaʍilan
gaƕeilan	ɡaʍilan
ƕeilohun	ʍilohun
gaƕeitjan	ɡaʍitjan
ƕeits	ʍits
ƕelauþs	ʍelɔθs
ƕileiks	ʍɪliks
ƕilftrjom	ʍɪlɸtrjom
ƕoftuli	ʍoɸtulɪ
ƕoh	ʍoh
ƕopan	ʍopan
ƕota	ʍota
ƕotjan	ʍotjan
gaƕotjan	ɡaʍotjan
Iaeirus	ɪairus
Iairaimias	ɪɛrɛmɪas
Iairaupaulein	ɪɛrɔpɔlin
Iaireiko	ɪɛriko
Iairusalem	ɪɛrusalem
Iairusaulwma	ɪɛrusɔlwma
Iairusaulwmeis	ɪɛrusɔlwmis
Iairusaulwmeite	ɪɛrusɔlwmite
Iaissaizis	ɪɛsːɛzɪs
Iakob	ɪakoβ
Iakobus	ɪakoβus
Iaredis	ɪareðɪs
Iareim	ɪarim
Iasson	ɪasːon
Iaurdanus	ɪɔrdanus
ibai	ɪβɛ
ibdaljin	ɪβdaljɪn
ibna	ɪβna
ibnaleiks	ɪβnaliks
ibnaskauns	ɪβnaskɔns
skauneis	skɔnis
ibnassus	ɪβnasːus
gaïbnjan	ɡɛ̈βnjan
ibns	ɪβn̥s
ibuks	ɪβuks
iddja	ɪdːja
idreiga	ɪðriɣa
idreigon	ɪðriɣon
gaïdreigon	ɡɛ̈ðriɣon
Idumaia	ɪðumɛa
idweit	ɪðwit
idweitjan	ɪðwitjan
Iesus	ɪesus
iftuma	ɪɸtuma
iggqar	ɪŋɡkʷar
igqis	ɪŋkʷɪs
ik	ɪk
ikei	ɪki
in	ɪn
inahei	ɪnahi
inahs	ɪnahs
ingardja	ɪnɡardja
inilo	ɪnɪlo
inkilþo	ɪnkɪlθo
inkunja	ɪnkunja
inmaideins	ɪnmɛðins
inn	ɪnː
inna	ɪnːa
innakunds	ɪnːakunds
innana	ɪnːana
innatgāhts	ɪnːatɡahts
innaþro	ɪnːaθro
inniujiþa	ɪnːɪujɪθa
innuma	ɪnːuma
insahts	ɪnsahts
inuh	ɪnuh
inuh	ɪnuh
inwindiþa	ɪnwɪndɪθa
inwinds	ɪnwɪnds
inwitoþs	ɪnwɪtoθs
Ioanan	ɪoanan
Ioda	ɪoða
Iohanna	ɪohanːa
Iohanna	ɪohanːa
Iohannes	ɪohanːes
Iora	ɪora
Ioreim	ɪorim
Iosef	ɪoseɸ
Iosezis	ɪosezɪs
is_M	ɪs_m
Isak	ɪsak
Iskariotes	ɪskarɪotes
Israel	ɪsrael
Israeleites	ɪsraelites
itan	ɪtan
fraïtan	ɸrɛ̈tan
Ituraia	ɪturɛa
iþ	ɪθ
Iudaia	ɪuðɛa
Iudaialand	ɪuðɛaland
Iudaius	ɪuðɛus
Judaius	juðɛus
iudaiwisko	ɪuðɛwɪsko
iudaiwiskon	ɪuðɛwɪskon
Iudas	ɪuðas
iumjo	ɪumjo
iup	ɪup
iupa	ɪupa
iupana	ɪupana
iupaþro	ɪupaθro
Iuse	ɪuse
iusila	ɪusɪla
iusiza	ɪusɪza
izei	ɪzi
ize	ɪze
izwar	ɪzwar
izwizei	ɪzwɪzi
ja	ja
jabai	jaβɛ
Jaeirus	jairus
jah	jah
jai	jɛ
jainar	jɛnar
jaind	jɛnd
jaindre	jɛndre
jaindwairþs	jɛndwɛrθs
jains	jɛns
jainþro	jɛnθro
Jairupulai	jɛrupulɛ
Janna	janːa
Jannes	janːes
jaþþe	jaθːe
jau	jɔ
Jaurdanau	jɔrdanɔ
jer	jer
jiuka	jɪuka
jiukan	jɪukan
gajiukan	ɡajɪukan
Jiuleis	jɪulis
jota	jota
ju	ju
judaiwisks	juðɛwɪsks
Judaius	juðɛus
Judas	juðas
juggs	juŋɡs
juk	juk
jukuzi	jukuzɪ
junda	junda
jūs	jus
Justus	justus
juþan	juθan
jūzei	juzi
Kaballarja	kaβalːarja
Kaeinan	kainan
Kafarnaum	kaɸarnɔm
Kaidmeiel	kɛðmiel
Kaidron	kɛðron
kaisar	kɛsar
kaisaragild	kɛsaraɣɪld
Kaisaria	kɛsarɪa
Kajafa	kajaɸa
kalbo	kalbo
kalds	kalds
kalkinassus	kalkɪnasːus
kalkjom	kalkjom
Kananeites	kananites
kann	kanː
kannjan	kanːjan
gakannjan	ɡakanːjan
uskannjan	uskanːjan
kapillon	kapɪlːon
kara	kara
Kareiaþiareim	kariaθɪarim
karkara	karkara
karon	karon
gakaron	ɡakaron
Karpus	karpus
kas	kas
kasja	kasja
katile	katɪle
Kaulaussaium	kɔlɔsːɛum
kaupatjan	kɔpatjan
kaupon	kɔpon
Kaurazein	kɔrazin
kaurban	kɔrban
kaurbaunan	kɔrbɔnan
kaurei	kɔri
Kaurinþius	kɔrɪnθɪus
Kaurinþon	kɔrɪnθon
kauriþa	kɔrɪθa
kaurjan	kɔrjan
anakaurjan	anakɔrjan
miþkaurjan	mɪθkɔrjan
kaurjos	kɔrjos
kaurn	kɔrn̥
kaurno	kɔrno
kausjan	kɔsjan
gakausjan	ɡakɔsjan
kawtsjo	kawtsjo
Kefas	keɸas
keinan	kinan
uskeinan	uskinan
miþuskeinan	mɪθuskinan
kelikn	kelɪkn̥
Kileikia	kɪlikɪa
kilþei	kɪlθi
kindins	kɪndɪns
kinnus	kɪnːus
kintus	kɪntus
kiusan	kɪusan
gakiusan	ɡakɪusan
uskiusan	uskɪusan
Klemaintau	klemɛntɔ
Klaimaintau	klɛmɛntɔ
klismjan	klɪsmjan
klismo	klɪsmo
kniu	knɪu
knodai	knoðɛ
knussjan	knusːjan
Kosam	kosam
Kreks	kreks
Kreskus	kreskus
Kretai	kretɛ
Kretes	kretes
Krispus	krɪspus
kriustan	krɪustan
gakroton	ɡakroton
krusts	krusts
kubitus	kuβɪtus
kukjan	kukjan
bikukjan	bɪkukjan
anakumbjan	anakumbjan
kumei	kumi
kunawida	kunawɪða
kuni	kunɪ
kunnan	kunːan
frakunnan	ɸrakunːan
gakunnan	ɡakunːan
kunnan	kunːan
anakunnan	anakunːan
atkunnan	atkunːan
gakunnan	ɡakunːan
ufkunnan	uɸkunːan
kunþi	kunθɪ
kunþs	kunθs
Kusa	kusa
Kustanteinus	kustantinus
kustus	kustus
Kwreinaius	kwrinɛus
Kwreinaius	kwrinɛus
laggamodei	laŋɡamoði
laggei	laŋɡi
laggs	laŋɡs
lagjan	laɣjan
aflagjan	aɸlaɣjan
analagjan	analaɣjan
atlagjan	atlaɣjan
faurlagjan	ɸɔrlaɣjan
galagjan	ɡalaɣjan
ufarlagjan	uɸarlaɣjan
uslagjan	uslaɣjan
laian	lɛan
lauan	lɔan
laiba	lɛβa
bilaibjan	bɪlɛβjan
bilaif	bɪlɛɸ
laigaion	lɛɣɛon
bilaigon	bɪlɛɣon
laikan	lɛkan
bilaikan	bɪlɛkan
laiks	lɛks
laiktjo	lɛktjo
lais	lɛs
laisareis	lɛsaris
laiseigs	lɛsiɣs
laiseins	lɛsins
laisjan	lɛsjan
galaisjan	ɡalɛsjan
uslaisjan	uslɛsjan
laistjan	lɛstjan
afarlaistjan	aɸarlɛstjan
galaistjan	ɡalɛstjan
laists	lɛsts
Laiwweis	lɛwːis
Laiwweiteis	lɛwːitis
Lamaik	lamɛk
lamb	lamb
land	land
lasiws	lasɪws
latei	lati
latjan	latjan
analatjan	analatjan
galatjan	ɡalatjan
lats	lats
laþaleiko	laθaliko
laþon	laθon
atlaþon	atlaθon
galaþon	ɡalaθon
laþons	laθons
lauan	lɔan
galaubjan	ɡalɔβjan
uslaubjan	uslɔβjan
Laudeikaia	lɔðikɛa
laudi	lɔðɪ
laufs	lɔɸs
laugnjan	lɔɣnjan
galaugnjan	ɡalɔɣnjan
lauhatjan	lɔhatjan
lauhmuni	lɔhmunɪ
Lauidjai	lɔɪðjɛ
laun	lɔn
launawargs	lɔnawarɡs
laus	lɔs
lausawaurdei	lɔsawɔrdi
lausawaurdi	lɔsawɔrdɪ
lausawaurds	lɔsawɔrds
laushandja	lɔshandja
lausjan	lɔsjan
galausjan	ɡalɔsjan
uslausjan	uslɔsjan
lausqiþrei	lɔskʷɪθri
lausqiþrs	lɔskʷɪθr̥s
Lazarus	lazarus
bileiban	bɪliβan
leihts	lihts
leiƕan	liʍan
leik	lik
leikains	likɛns
leikan	likan
galeikan	ɡalikan
fauragaleikan	ɸɔraɣalikan
leikeins	likins
leikeis	likis
sildaleikjan	sɪldalikjan
gáleikon	ɡalikon
gagáleikon	ɡaɣalikon
ingáleikon	ɪnɡalikon
miþgáleikon	mɪθɡalikon
þairhgáleikon	θɛrhɡalikon
lein	lin
leitan	litan
leitils	litɪls
afleiþan	aɸliθan
bileiþan	bɪliθan
galeiþan	ɡaliθan
inngaleiþan	ɪnːɣaliθan
miþinngaleiþan	mɪθɪnːɣaliθan
hindarleiþan	hɪndarliθan
þairhleiþan	θɛrhliθan
ufarleiþan	uɸarliθan
usleiþan	usliθan
leiþu	liθu
lekeis	lekis
lekinassus	lekɪnasːus
lekinon	lekɪnon
galeikinon	ɡalikɪnon
letan	letan
afletan	aɸletan
fraletan	ɸraletan
usletan	usletan
andletnan	andletnan
lew	lew
lewjan	lewjan
fralewjan	ɸralewjan
galewjan	ɡalewjan
libains	lɪβɛns
liban	lɪβan
miþliban	mɪθlɪβan
aflifnan	aɸlɪɸnan
ligan	lɪɣan
atligan	atlɪɣan
ufligan	uɸlɪɣan
ligrs	lɪɣr̥s
lima	lɪma
aflinnan	aɸlɪnːan
lisan	lɪsan
galisan	ɡalɪsan
listeigs	lɪstiɣs
lists	lɪsts
litai	lɪtɛ
liteins	lɪtins
miþlitjan	mɪθlɪtjan
liþus	lɪθus
liubaleiks	lɪuβaliks
liudan	lɪuðan
awiliudon	awɪlɪuðon
liufs	lɪuɸs
liuga	lɪuɣa
liugan	lɪuɣan
galiugan	ɡalɪuɣan
liugan	lɪuɣan
liugn	lɪuɣn̥
liugnapraufetus	lɪuɣnaprɔɸetus
liugnawaurds	lɪuɣnawɔrds
liugnja	lɪuɣnja
liuhadei	lɪuhaði
liuhadeins	lɪuhaðins
liuhadeins	lɪuhaðins
liuhaþ	lɪuhaθ
liuhtjan	lɪuhtjan
galiuhtjan	ɡalɪuhtjan
inliuhtjan	ɪnlɪuhtjan
fraliusan	ɸralɪusan
liutei	lɪuti
liuts	lɪuts
liuþareis	lɪuθaris
liuþon	lɪuθon
lofa	loɸa
Loþ	loθ
lubains	luβɛns
lubjaleis	luβjalis
lubjaleisei	luβjalisi
ludja	luðja
luftu	luɸtu
galūkan	ɡalukan
uslukan	uslukan
lukarn	lukarn̥
lukarnastaþa	lukarnastaθa
Lukas	lukas
Lukius	lukɪus
galuknan	ɡaluknan
usluknan	usluknan
lun	lun
fralusnan	ɸralusnan
luston	luston
lustus	lustus
lustusama	lustusama
luton	luton
usluton	usluton
Lwddomaeis	lwdːomais
Lwsanius	lwsanɪus
Lwstrws	lwstrws
Maeinan	mainan
magan	maɣan
gamagan	ɡamaɣan
magaþei	maɣaθi
magaþs	maɣaθs
Magdalan	maɣdalan
Magdalene	maɣdalene
magula	maɣula
magus	maɣus
Mahaþ	mahaθ
mahteigs	mahtiɣs
anamahtjan	anamahtjan
mahts	mahts
mahts	mahts
maidjan	mɛðjan
inmaidjan	ɪnmɛðjan
maihstus	mɛhstus
Mailaian	mɛlɛan
maile	mɛle
Mailkei	mɛlki
maimbrana	mɛmbrana
gámainjan	ɡamɛnjan
gagámainjan	ɡaɣamɛnjan
mais	mɛs
Maisaullam	mɛsɔlːam
maists	mɛsts
maist	mɛst
maitan	mɛtan
afmaitan	aɸmɛtan
bimaitan	bɪmɛtan
gamaitan	ɡamɛtan
usmaitan	usmɛtan
maiþms	mɛθm̥s
maiza	mɛza
Makeibis	makiβɪs
Makidoneis	makɪðonis
Makidonja	makɪðonja
Makmas	makmas
malan	malan
Malailaiel	malɛlɛel
Malkus	malkus
malma	malma
malo	malo
gamalwjan	ɡamalwjan
Mambres	mambres
mammo	mamːo
mammona	mamːona
bimampjan	bɪmampjan
man	man
managdūþs	manaɣduθs
managei	manaɣi
managfalþs	manaɣɸalθs
managjan	manaɣjan
managnan	manaɣnan
usmanagnan	usmanaɣnan
manags	manaɣs
manamaurþrja	manamɔrθrja
manaseþs	manaseθs
manaulja	manɔlja
manleika	manlika
manna	manːa
manna	manːa
mannahun	manːahun
manniskodus	manːɪskoðus
mannisks	manːɪsks
manwiþa	manwɪθa
manwjan	manwjan
fauramanwjan	ɸɔramanwjan
gamanwjan	ɡamanwjan
fauragamanwjan	ɸɔraɣamanwjan
manwus	manwus
maran_aþa	maran_aθa
marei	mari
Maria	marɪa
marikreitum	marɪkritum
marisaiws	marɪsɛws
Marja	marja
marka	marka
Markaillaus	markɛlːɔs
gamarkon	ɡamarkon
Markus	markus
marwtre	marwtre
Marþa	marθa
marzeins	marzins
marzjan	marzjan
afmarzjan	aɸmarzjan
gamarzjan	ɡamarzjan
matibalgs	matɪβalɡs
matjan	matjan
gamatjan	ɡamatjan
mats	mats
Mattaþanis	matːaθanɪs
Mattaþius	matːaθɪus
Matþaius	matθɛus
Matþat	matθat
maþa	maθa
maþl	maθl̥
maþlein	maθlin
maþljan	maθljan
Maþusalis	maθusalɪs
maudjan	mɔðjan
gamaudjan	ɡamɔðjan
maurgins	mɔrɡɪns
gamaurgjan	ɡamɔrɡjan
maurnan	mɔrnan
maurþr	mɔrθr̥
maurþrjan	mɔrθrjan
mawi	mawɪ
mawilo	mawɪlo
megs	meɣs
meins	mins
meki	mekɪ
mel	mel
mela	mela
meljan	meljan
anameljan	anameljan
faurameljan	ɸɔrameljan
gameljan	ɡameljan
fauragameljan	ɸɔraɣameljan
ufmeljan	uɸmeljan
ufarmeljan	uɸarmeljan
mena	mena
menoþs	menoθs
mereins	merins
Merila	merɪla
meriþa	merɪθa
merjan	merjan
merjands	merjands
usmerjan	usmerjan
wailamerjan	wɛlamerjan
wajamerjan	wajamerjan
usmernan	usmernan
mes	mes
midgardiwaddjus	mɪðɡardɪwadːjus
midjasweipains	mɪðjaswipɛns
midjis	mɪðjɪs
midjungards	mɪðjunɡards
miduma	mɪðuma
midumonds	mɪðumonds
mikildūþs	mɪkɪlduθs
mikilei	mɪkɪli
mikiljan	mɪkɪljan
gamikiljan	ɡamɪkɪljan
mikilnan	mɪkɪlnan
mikils	mɪkɪls
mikilþuhts	mɪkɪlθuhts
mildiþa	mɪldɪθa
milhma	mɪlhma
militon	mɪlɪton
miliþ	mɪlɪθ
miluks	mɪluks
mimz	mɪmz
minnists	mɪnːɪsts
minniza	mɪnːɪza
mins	mɪns
minznan	mɪnznan
missadeþs	mɪsːaðeθs
missaleiks	mɪsːaliks
missaqiss	mɪsːakʷɪsː
missataujands	mɪsːatɔjands
misso	mɪsːo
mitadjo	mɪtaðjo
mitan	mɪtan
gamitan	ɡamɪtan
usmitan	usmɪtan
mitaþs	mɪtaθs
miton	mɪton
ufarmiton	uɸarmɪton
mitons	mɪtons
miþ	mɪθ
miþgardawaddjus	mɪθɡardawadːjus
miþþan	mɪθːan
miþþanei	mɪθːani
miþwissei	mɪθwɪsːi
mizdo	mɪzdo
modags	moðaɣs
afmojan	aɸmojan
Moses	moses
mota	mota
gamotan	ɡamotan
motareis	motaris
motastaþs	motastaθs
gamotjan	ɡamotjan
wiþragamotjan	wɪθraɣamotjan
moþs	moθs
mukamodei	mukamoði
mulda	mulda
muldeins	muldins
faurmūljan	ɸɔrmuljan
munan	munan
gamunan	ɡamunan
munan	munan
mundon	mundon
mundrei	mundri
ufarmunnon	uɸarmunːon
muns	muns
munþs	munθs
Nabaw	naβaw
nadre	naðre
Naem	naem
Naggai	naŋɡɛ
ganagljan	ɡanaɣljan
binah	bɪnah
ganah	ɡanah
Nahasson	nahasːon
nahtamats	nahtamats
nahts	nahts
Naiman	nɛman
naiteins	nɛtins
ganaitjan	ɡanɛtjan
Naitofaþeis	nɛtoɸaθis
Nakor	nakor
namnjan	namnjan
ganamnjan	ɡanamnjan
namo	namo
anananþjan	anananθjan
gananþjan	ɡananθjan
naqadei	nakʷaði
naqaþs	nakʷaθs
nardus	nardus
naseins	nasins
nasjan	nasjan
nasjands	nasjands
ganasjan	ɡanasjan
nati	natɪ
natjan	natjan
ganatjan	ɡanatjan
Naþan	naθan
Naubaimbair	nɔβɛmbɛr
naudibandi	nɔðɪβandɪ
naudiþaurfts	nɔðɪθɔrɸts
naudiþaurfts	nɔðɪθɔrɸts
Nauel	nɔel
nauh	nɔh
nauhþan	nɔhθan
nauhþanuh	nɔhθanuh
nauhuþþan	nɔhuθːan
Naum	nɔm
naus	nɔs
nauþjan	nɔθjan
ananauþjan	ananɔθjan
nauþs	nɔθs
nawis	nawɪs
ganawistron	ɡanawɪstron
miþganawistron	mɪθɡanawɪstron
Nazaraiþ	nazarɛθ
Nazoraius	nazorɛus
Nazorenus	nazorenus
ne	ne
neƕ	neʍ
neƕis	neʍɪs
neƕa	neʍa
neƕjan	neʍjan
atneƕjan	atneʍjan
neƕundja	neʍundja
nei	ni
neiþ	niθ
Nekaudemus	nekɔðemus
neiwan	niwan
Nerins	nerɪns
neþla	neθla
ni	nɪ
nibai	nɪβɛ
nidwa	nɪðwa
nih	nɪh
Nikaudemus	nɪkɔðemus
niman	nɪman
afniman	aɸnɪman
andniman	andnɪman
atniman	atnɪman
biniman	bɪnɪman
disniman	dɪsnɪman
franiman	ɸranɪman
ganiman	ɡanɪman
inniman	ɪnːɪman
miþniman	mɪθnɪman
usniman	usnɪman
ganisan	ɡanɪsan
nist	nɪst
niþan	nɪθan
niþjis	nɪθjɪs
niþjo	nɪθjo
niu	nɪu
niuhseins	nɪuhsins
biniuhsjan	bɪnɪuhsjan
ananiujan	ananɪujan
niujasatiþs	nɪujasatɪθs
niujis	nɪujɪs
niujiþa	nɪujɪθa
niuklahei	nɪuklahi
niuklahs	nɪuklahs
niun	nɪun
niunda	nɪunda
niuntehund	nɪuntehund
niutan	nɪutan
ganiutan	ɡanɪutan
ganohjan	ɡanohjan
ganohnan	ɡanohnan
notin	notɪn
nu	nu
nuh	nuh
nunu	nunu
nuta	nuta
Nwmfan	nwmɸan
o	o
Obeid	oβið
Odueia	oðuia
ogan	oɣan
ogjan	oɣjan
ohteigo	ohtiɣo
Osaiin	osɛɪn
osanna	osanːa
paida	pɛða
gapaidon	ɡapɛðon
paintekuste	pɛntekuste
Paitrus	pɛtrus
papan	papan
parakletus	parakletus
paraskaiwe	paraskɛwe
paska	paska
pasxa	pasχa
Pauntius	pɔntɪus
paurpura	pɔrpura
paurpaura	pɔrpɔra
paurpuroþs	pɔrpuroθs
Pawlus	pawlus
peikabagms	pikaβaɣm̥s
Peilatus	pilatus
pistikeins	pɪstɪkins
plapja	plapja
plat	plat
plinsjan	plɪnsjan
anapraggan	anapraŋɡan
praitoriaun	prɛtorɪɔn
praizbwtairei	prɛzbwtɛri
praizbwtairi	prɛzbwtɛrɪ
praufeteis	prɔɸetis
praufetes	prɔɸetes
praufetja	prɔɸetja
praufetjan	prɔɸetjan
Priska	prɪska
psalmon	psalmon
pugg	puŋɡ
pund	pund
qainon	kʷɛnon
qairrei	kʷɛrːi
qairrus	kʷɛrːus
qairu	kʷɛru
Qartus	kʷartus
qens	kʷens
qiman	kʷɪman
anaqiman	anakʷɪman
biqiman	bɪkʷɪman
fauraqiman	ɸɔrakʷɪman
fraqiman	ɸrakʷɪman
gaqiman	ɡakʷɪman
miþqiman	mɪθkʷɪman
usqiman	uskʷɪman
qinakunds	kʷɪnakunds
qineins	kʷɪnins
qino	kʷɪno
qisteins	kʷɪstins
qistjan	kʷɪstjan
fraqistjan	ɸrakʷɪstjan
usqistjan	uskʷɪstjan
fraqistnan	ɸrakʷɪstnan
qiþan	kʷɪθan
afqiþan	aɸkʷɪθan
anaqiþan	anakʷɪθan
andqiþan	andkʷɪθan
faurqiþan	ɸɔrkʷɪθan
fauraqiþan	ɸɔrakʷɪθan
fraqiþan	ɸrakʷɪθan
gaqiþan	ɡakʷɪθan
miþqiþan	mɪθkʷɪθan
usqiþan	uskʷɪθan
qiþuhafto	kʷɪθuhaɸto
qiþus	kʷɪθus
anaqiujan	anakʷɪujan
gaqiujan	ɡakʷɪujan
miþgaqiujan	mɪθɡakʷɪujan
gaqiunan	ɡakʷɪunan
qius	kʷɪus
qrammiþa	kʷramːɪθa
qums	kʷums
rabbaunei	rabːɔni
rabbei	rabːi
Ragaw	raɣaw
ragin	raɣɪn
ragineis	raɣɪnis
raginon	raɣɪnon
garaginon	ɡaraɣɪnon
rahnjan	rahnjan
faurarahnjan	ɸɔrarahnjan
garahnjan	ɡarahnjan
rahton	rahton
Raibaikka	rɛβɛkːa
raidjan	rɛðjan
garaidjan	ɡarɛðjan
raihtis	rɛhtɪs
gáraihtjan	ɡarɛhtjan
atgáraihtjan	atɡarɛhtjan
raihts	rɛhts
raihtaba	rɛhtaβa
urraisjan	urːɛsjan
raka	raka
ufrakjan	uɸrakjan
Rama	rama
urrannjan	urːanːjan
rasta	rasta
garaþjan	ɡaraθjan
raþjo	raθjo
raþizo	raθɪzo
biraubon	bɪrɔβon
inrauhtjan	ɪnrɔhtjan
raupjan	rɔpjan
raus	rɔs
rauþs	rɔθs
razda	razda
razn	razn̥
garedan	ɡareðan
fauragaredan	ɸɔraɣareðan
undredan	undreðan
urredan	urːeðan
reiki	rikɪ
reikinon	rikɪnon
reikeis	rikis
reiks	riks
reiks	riks
reiran	riran
inreiran	ɪnriran
reiro	riro
urreisan	urːisan
Resa	resa
rign	rɪɣn̥
rignjan	rɪɣnjan
rikan	rɪkan
rimis	rɪmɪs
rinnan	rɪnːan
andrinnan	andrɪnːan
atrinnan	atrɪnːan
duatrinnan	duatrɪnːan
birinnan	bɪrɪnːan
durinnan	durɪnːan
fairrinnan	ɸɛrːɪnːan
faurrinnan	ɸɔrːɪnːan
frarinnan	ɸrarɪnːan
garinnan	ɡarɪnːan
undrinnan	undrɪnːan
urrinnan	urːɪnːan
rinno	rɪnːo
riqis	rɪkʷɪs
riqizeins	rɪkʷɪzins
riqizjan	rɪkʷɪzjan
riurei	rɪuri
riurjan	rɪurjan
riureis	rɪuris
riurs	rɪurs
rodjan	roðjan
birodjan	bɪroðjan
miþrodjan	mɪθroðjan
rohsns	rohsn̥s
Rufus	ruɸus
rūmis	rumɪs
Rūma	ruma
urrūmnan	urːumnan
Rūmoneis	rumonis
rūms	rums
rūna	runa
runs	runs
sa	sa
Sabaillius	saβɛlːɪus
saban	saβan
Sabaoþ	saβaoθ
sabbato	sabːato
Saddukaieis	sadːukɛis
sads	saðs
saei	sai
saggqjan	saŋɡkʷjan
ufsaggqjan	uɸsaŋɡkʷjan
ufsaggqjan	uɸsaŋɡkʷjan
saggqa	saŋɡkʷa
saggws	saɡɡws
sah	sah
saƕazuh	saʍazuh
sai	sɛ
saian	sɛan
insaian	ɪnsɛan
saihs	sɛhs
saihsta	sɛhsta
saiƕan	sɛʍan
andsaiƕan	andsɛʍan
atsaiƕan	atsɛʍan
bisaiƕan	bɪsɛʍan
gasaiƕan	ɡasɛʍan
insaiƕan	ɪnsɛʍan
þairhsaiƕan	θɛrhsɛʍan
ussaiƕan	usːɛʍan
insailjan	ɪnsɛljan
Sailaum	sɛlɔm
Saimaiein	sɛmɛin
sainjan	sɛnjan
sáir	sɛr
Sairok	sɛrok
saiwala	sɛwala
saiws	sɛws
Saixaineia	sɛχɛnia
sakan	sakan
andsakan	andsakan
gasakan	ɡasakan
insakan	ɪnsakan
anainsakan	anɛnsakan
ussakan	usːakan
sakjo	sakjo
sakkus	sakːus
sakuls	sakuls
Salamis	salamɪs
Salaþiel	salaθɪel
salbon	salbon
gasalbon	ɡasalbon
salbons	salbons
saldra	saldra
saliþwos	salɪθwos
saljan	saljan
andsaljan	andsaljan
gasaljan	ɡasaljan
saljan	saljan
ussaljan	usːaljan
Salmon	salmon
Salome	salome
salt	salt
saltan	saltan
sama	sama
samafraþjis	samaɸraθjɪs
samakuns	samakuns
samalauþs	samalɔθs
samaleiks	samaliks
samaleiko	samaliko
samana	samana
samaqiss	samakʷɪsː
Samareites	samarites
Samaria	samarɪa
samasaiwals	samasɛwals
samaþ	samaθ
samjan	samjan
sandjan	sandjan
gasandjan	ɡasandjan
fauragasandjan	ɸɔraɣasandjan
insandjan	ɪnsandjan
miþinsandjan	mɪθɪnsandjan
gamiþsandjan	ɡamɪθsandjan
ussandjan	usːandjan
Saraipta	sarɛpta
Sarra	sarːa
sarwa	sarwa
Satana	satana
satjan	satjan
afsatjan	aɸsatjan
atsatjan	atsatjan
bisatjan	bɪsatjan
gasatjan	ɡasatjan
fauragasatjan	ɸɔraɣasatjan
miþsatjan	mɪθsatjan
ussatjan	usːatjan
saþs	saθs
Saudauma	sɔðɔma
sauhts	sɔhts
sauïl	sɔɪ̈l
Saulaumon	sɔlɔmon
bisauljan	bɪsɔljan
bisaulnan	bɪsɔlnan
sauls	sɔls
Saur	sɔr
Saurais	sɔrɛs
saurga	sɔrɡa
saurgan	sɔrɡan
Saurini	sɔrɪnɪ
sauþa	sɔθa
sauþs	sɔθs
sei	si
Seidona	siðona
Seidoneis	siðonis
Seimon	simon
Seina	sina
sik	sɪk
seinaigairnai	sinɛɣɛrnɛ
seins	sins
seiteins	sitins
seiþus	siθus
selei	seli
sels	sels
Sem	sem
Seþ	seθ
sibakþanei	sɪβakθani
sibja	sɪβja
gasibjon	ɡasɪβjon
sibun	sɪβun
sibuntehund	sɪβuntehund
sidon	sɪðon
sidus	sɪðus
sifan	sɪɸan
siggwan	sɪɡɡwan
ussiggwan	usːɪɡɡwan
sigis	sɪɣɪs
sigislaun	sɪɣɪslɔn
sigljan	sɪɣljan
faursigljan	ɸɔrsɪɣljan
gasigljan	ɡasɪɣljan
sigljo	sɪɣljo
sigqan	sɪŋkʷan
dissigqan	dɪsːɪŋkʷan
gasiggqan	ɡasɪŋɡkʷan
sihw	sɪhw
sikls	sɪkl̥s
anasilan	anasɪlan
silba	sɪlba
Silbanus	sɪlbanus
silbasiuneis	sɪlbasɪunis
silbawiljis	sɪlbawɪljɪs
sildaleik	sɪldalik
sildaleikjan	sɪldalikjan
sildaleiknan	sɪldaliknan
sildaleiks	sɪldaliks
Siloam	sɪloam
silubr	sɪluβr̥
silubreins	sɪluβrins
simle	sɪmle
sinapis	sɪnapɪs
sineigs	sɪniɣs
sinista	sɪnɪsta
sinteins	sɪntins
sinteino	sɪntino
sinþs	sɪnθs
Sion	sɪon
siponeis	sɪponis
siponjan	sɪponjan
sitan	sɪtan
andsitan	andsɪtan
bisitan	bɪsɪtan
bisitands	bɪsɪtands
dissitan	dɪsːɪtan
gasitan	ɡasɪtan
ussitan	usːɪtan
sitls	sɪtl̥s
siujan	sɪujan
siukan	sɪukan
siukei	sɪuki
siuks	sɪuks
siuns	sɪuns
skaban	skaβan
biskaban	bɪskaβan
skadus	skaðus
ufarskadwjan	uɸarskaðwjan
skaftjan	skaɸtjan
skaidan	skɛðan
afskaidan	aɸskɛðan
disskaidan	dɪsːkɛðan
gaskaidan	ɡaskɛðan
gaskaidnan	ɡaskɛðnan
skal	skal
skalja	skalja
skalkinassus	skalkɪnasːus
skalkinon	skalkɪnon
miþskalkinon	mɪθskalkɪnon
skalks	skalks
skaman	skaman
gaskaman	ɡaskaman
skanda	skanda
gaskapjan	ɡaskapjan
Skariotau	skarɪotɔ
usskarjan	usːkarjan
skattja	skatːja
skatts	skatːs
skaþaila	skaθɛla
skaþis	skaθɪs
skaþjan	skaθjan
gaskaþjan	ɡaskaθjan
skaþuls	skaθuls
skaudaraip	skɔðarɛp
skauns	skɔns
skauneis	skɔnis
skaurpjo	skɔrpjo
skauta	skɔta
usskaujan	usːkɔjan
skeimam	skimam
skeinan	skinan
biskeinan	bɪskinan
skeireins	skirins
gaskeirjan	ɡaskirjan
skeirs	skirs
skewjan	skewjan
skildus	skɪldus
skilja	skɪlja
skilliggs	skɪlːɪŋɡs
skip	skɪp
afskiuban	aɸskɪuβan
skohs	skohs
skohsl	skohsl̥
disskreitan	dɪsːkritan
disskritnan	dɪsːkrɪtnan
skufta	skuɸta
skuggwa	skuɡɡwa
skula	skula
skulan	skulan
skūra	skura
Skwþus	skwθus
slahals	slahals
slahan	slahan
afslahan	aɸslahan
slahs	slahs
slaihts	slɛhts
slauhts	slɔhts
afslaupjan	aɸslɔpjan
afslauþjan	aɸslɔθjan
afslauþnan	aɸslɔθnan
slawan	slawan
anaslawan	anaslawan
gaslawan	ɡaslawan
sleiþa	sliθa
sleiþei	sliθi
gasleiþjan	ɡasliθjan
sleiþs	sliθs
sleideis	sliðis
slepan	slepan
anaslepan	anaslepan
gaslepan	ɡaslepan
sleps	sleps
fraslindan	ɸraslɪndan
sliupan	slɪupan
ufsliupan	uɸslɪupan
smairþr	smɛrθr̥
smakka	smakːa
smakkabagms	smakːaβaɣm̥s
smalista	smalɪsta
smarna	smarna
bismeitan	bɪsmitan
gasmeitan	ɡasmitan
gasmiþon	ɡasmɪθon
smwrn	smwrn̥
snaga	snaɣa
snaiws	snɛws
atsnarpjan	atsnarpjan
sneiþan	sniθan
afsneiþan	aɸsniθan
ufsneiþan	uɸsniθan
sniumjan	snɪumjan
gasniumjan	ɡasnɪumjan
sniumundo	snɪumundo
sniumundos	snɪumundos
sniwan	snɪwan
duatsniwan	duatsnɪwan
bisniwan	bɪsnɪwan
faurbisniwan	ɸɔrbɪsnɪwan
faursniwan	ɸɔrsnɪwan
gasniwan	ɡasnɪwan
snorjo	snorjo
snutrei	snutri
snutrs	snutr̥s
so	so
sokareis	sokaris
sokeins	sokins
sokjan	sokjan
gasokjan	ɡasokjan
miþsokjan	mɪθsokjan
ussokjan	usːokjan
sokns	sokn̥s
Soseipatrus	sosipatrus
soþa	soθa
gasoþjan	ɡasoθjan
spaikulatur	spɛkulatur
spaiskuldra	spɛskuldra
sparwa	sparwa
spaurds	spɔrds
speiwan	spiwan
andspeiwan	andspiwan
bispeiwan	bɪspiwan
gaspeiwan	ɡaspiwan
spediza	speðɪza
spedists	speðɪsts
spedumists	speðumɪsts
spilda	spɪlda
spill	spɪlː
spilla	spɪlːa
spillon	spɪlːon
gaspillon	ɡaspɪlːon
þiuþspillon	θɪuθspɪlːon
usspillon	usːpɪlːon
wailaspillon	wɛlaspɪlːon
spinnan	spɪnːan
sprauto	sprɔto
spwreidans	spwriðans
stabeis	staβis
usstagg	usːtaŋɡ
gastagqjan	ɡastaŋkʷjan
Staifanus	stɛɸanus
staiga	stɛɣa
stainahs	stɛnahs
staineins	stɛnins
stainjan	stɛnjan
stains	stɛns
stairno	stɛrno
stairo	stɛro
staks	staks
andstaldan	andstaldan
gastaldan	ɡastaldan
stamms	stamːs
standan	standan
afstandan	aɸstandan
andstandan	andstandan
atstandan	atstandan
bistandan	bɪstandan
faurastandan	ɸɔrastandan
gastandan	ɡastandan
instandan	ɪnstandan
miþstandan	mɪθstandan
twisstandan	twɪsːtandan
usstandan	usːtandan
staþa	staθa
staþs	staθs
staua	stɔa
staua	stɔa
stauastols	stɔastols
gastaurknan	ɡastɔrknan
andstaurran	andstɔrːan
stautan	stɔtan
steigan	stiɣan
atsteigan	atstiɣan
gasteigan	ɡastiɣan
ufarsteigan	uɸarstiɣan
ussteigan	usːtiɣan
stibna	stɪβna
usstigg	usːtɪŋɡ
stigqan	stɪŋkʷan
bistigqan	bɪstɪŋkʷan
gastiggqan	ɡastɪŋɡkʷan
stikls	stɪkl̥s
stiks	stɪks
stilan	stɪlan
stiur	stɪur
stiurjan	stɪurjan
stiwiti	stɪwɪtɪ
anastodjan	anastoðjan
dustodjan	dustoðjan
stojan	stojan
gastojan	ɡastojan
stols	stols
stomin	stomɪn
gastoþan	ɡastoθan
straujan	strɔjan
gastraujan	ɡastrɔjan
ufstraujan	uɸstrɔjan
striks	strɪks
stubjus	stuβjus
sulja	sulja
gasuljan	ɡasuljan
suman	suman
sums	sums
sundro	sundro
sunja	sunja
Sunjaifriþas	sunjɛɸrɪθas
sunjeins	sunjins
sunjis	sunjɪs
sunjon	sunjon
gasunjon	ɡasunjon
sunjons	sunjons
sunno	sunːo
suns	suns
sunsaiw	sunsɛw
sunsei	sunsi
sunus	sunus
supon	supon
gasupon	ɡasupon
suqnis	sukʷnɪs
Susanna	susanːa
sutis	sutɪs
suþjan	suθjan
suþjon	suθjon
swa	swa
swaei	swai
afswaggwjan	aɸswaɡɡwjan
swah	swah
swaihra	swɛhra
swaihro	swɛhro
afswairban	aɸswɛrban
biswairban	bɪswɛrban
swalauþs	swalɔθs
swaleiks	swaliks
swamm	swamː
swaran	swaran
biswaran	bɪswaran
ufarswaran	uɸarswaran
sware	sware
swartiza	swartɪza
swartizla	swartɪzla
swarts	swarts
swaswe	swaswe
swaþþan	swaθːan
swau	swɔ
swe	swe
swegniþa	sweɣnɪθa
swegnjan	sweɣnjan
sweiban	swiβan
swein	swin
sweran	sweran
gasweran	ɡasweran
unsweran	unsweran
sweriþa	swerɪθa
swers	swers
swes	swes
swes	swes
sweþauh	sweθɔh
swibla	swɪβla
swiglja	swɪɣlja
swiglon	swɪɣlon
swigniþa	swɪɣnɪθa
swiknei	swɪkni
swikneins	swɪknins
swikniþa	swɪknɪθa
swikns	swɪkn̥s
gaswikunþjan	ɡaswɪkunθjan
swikunþs	swɪkunθs
swiltan	swɪltan
gaswiltan	ɡaswɪltan
miþgaswiltan	mɪθɡaswɪltan
swinþei	swɪnθi
gaswinþjan	ɡaswɪnθjan
inswinþjan	ɪnswɪnθjan
swinþnan	swɪnθnan
gaswinþnan	ɡaswɪnθnan
swinþs	swɪnθs
swistar	swɪstar
Swmaion	swmɛon
swnagogafaþs	swnaɣoɣaɸaθs
swnagoge	swnaɣoɣe
Swntwke	swntwke
swogatjan	swoɣatjan
gaswogjan	ɡaswoɣjan
ufswogjan	uɸswoɣjan
Swria	swrɪa
swultawairþja	swultawɛrθja
swumfsl	swumɸsl̥
tagl	taɣl̥
tagr	taɣr̥
tagrjan	taɣrjan
tahjan	tahjan
distahjan	dɪstahjan
taihswa	tɛhswa
taihswa	tɛhswa
taihun	tɛhun
taihunda	tɛhunda
taihuntaihundfalþs	tɛhuntɛhundɸalθs
taihuntehund	tɛhuntehund
taihunteweis	tɛhuntewis
taikn	tɛkn̥
taiknjan	tɛknjan
gataiknjan	ɡatɛknjan
ustaiknjan	ustɛknjan
taikns	tɛkn̥s
tainjo	tɛnjo
tains	tɛns
distairan	dɪstɛran
gatairan	ɡatɛran
Tairtius	tɛrtɪus
taitrarkes	tɛtrarkes
taleiþa	taliθa
talzeins	talzins
talzjan	talzjan
talzjands	talzjands
gatalzjan	ɡatalzjan
gatamjan	ɡatamjan
tandjan	tandjan
gatandjan	ɡatandjan
intandjan	ɪntandjan
gatarhjan	ɡatarhjan
tarmjan	tarmjan
gatarnjan	ɡatarnjan
taui	tɔɪ
taujan	tɔjan
gataujan	ɡatɔjan
missataujan	mɪsːatɔjan
aftaurnan	aɸtɔrnan
distaurnan	dɪstɔrnan
gataurnan	ɡatɔrnan
Teibairius	tiβɛrɪus
gateihan	ɡatihan
fauragateihan	ɸɔraɣatihan
teikan	tikan
Teimaius	timɛus
Teimauþaius	timɔθɛus
Teitus	titus
tekan	tekan
attekan	atːekan
tewa	tewa
gatewjan	ɡatewjan
Tibairiadau	tɪβɛrɪaðɔ
Tibairiadeis	tɪβɛrɪaðis
tigjus	tɪɣjus
andtilon	andtɪlon
gatilon	ɡatɪlon
gagátilon	ɡaɣatɪlon
til	tɪl
gatiman	ɡatɪman
timbrjan	tɪmbrjan
timreins	tɪmrins
timrja	tɪmrja
timrjan	tɪmrjan
anatimrjan	anatɪmrjan
gatimrjan	ɡatɪmrjan
miþgatimrjan	mɪθɡatɪmrjan
tiuhan	tɪuhan
aftiuhan	aɸtɪuhan
attiuhan	atːɪuhan
innattiuhan	ɪnːatːɪuhan
bitiuhan	bɪtɪuhan
gatiuhan	ɡatɪuhan
miþgatiuhan	mɪθɡatɪuhan
ustiuhan	ustɪuhan
Tobeias	toβias
Trakauneitidaus	trakɔnitɪðɔs
trauains	trɔɛns
trauan	trɔan
gatrauan	ɡatrɔan
Trauadai	trɔaðɛ
trausti	trɔstɪ
triggwa	trɪɡɡwa
triggws	trɪɡɡws
triggwaba	trɪɡɡwaβa
trigo	trɪɣo
anatrimpan	anatrɪmpan
triu	trɪu
triweins	trɪwins
trudan	truðan
gatrudan	ɡatruðan
intrusgjan	ɪntrusɡjan
ufartrusnjan	uɸartrusnjan
tuggl	tuŋɡl̥
tuggo	tuŋɡo
tulgiþa	tulɡɪθa
tulgjan	tulɡjan
gatulgjan	ɡatulɡjan
tulgus	tulɡus
tundnan	tundnan
intundnan	ɪntundnan
tunþus	tunθus
twai	twɛ
twalibwintrus	twalɪβwɪntrus
twalif	twalɪɸ
tweifleins	twiɸlins
tweifljan	twiɸljan
tweifl	twiɸl̥
tweihnai	twihnɛ
twisstass	twɪsːtasː
Twkeikus	twkikus
Twra	twra
Þaddaius	θadːɛus
þadei	θaði
þagk	θaŋk
þagkjan	θaŋkjan
andþagkjan	andθaŋkjan
biþagkjan	bɪθaŋkjan
þahains	θahɛns
þahan	θahan
gaþahan	ɡaθahan
þāho	θaho
Þaiaufeilus	θɛɔɸilus
þairh	θɛrh
þairko	θɛrko
gaþairsan	ɡaθɛrsan
Þaissaloneikai	θɛsːalonikɛ
Þaissalauneikaie	θɛsːalɔnikɛe
þan	θan
þanamais	θanamɛs
þanaseiþs	θanasiθs
þande	θande
þanei	θani
ufþanjan	uɸθanjan
þank	θank
þannu	θanːu
þanuh	θanuh
þar	θar
Þara	θara
þarba	θarba
gaþarban	ɡaθarban
þarbs	θarbs
þarei	θari
þarf	θarɸ
þarihs	θarɪhs
þaruh	θaruh
þata	θata
þatain	θatɛn
þatainei	θatɛni
þatei	θati
þatist	θatɪst
þatuh	θatuh
þaþro	θaθro
þaþroei	θaθroi
þaþroh	θaθroh
þau	θɔ
þauhjabai	θɔhjaβɛ
þaurban	θɔrban
þaurfts	θɔrɸts
þaurfts	θɔrɸts
þaurneins	θɔrnins
þaurnus	θɔrnus
þaurp	θɔrp
þaursjan	θɔrsjan
afþaursjan	aɸθɔrsjan
gaþaursnan	ɡaθɔrsnan
þaurstei	θɔrsti
þaursus	θɔrsus
þe	θe
þeei	θei
þei	θi
þeihan	θihan
gaþeihan	ɡaθihan
ufarþeihan	uɸarθihan
þeihs	θihs
þeiƕo	θiʍo
þeins	θins
þewisa	θewɪsa
atþinsan	atθɪnsan
þishun	θɪshun
þisƕaduh	θɪsʍaðuh
þisƕah	θɪsʍah
þisƕaruh	θɪsʍaruh
þisƕazuh	θɪsʍazuh
þiubi	θɪuβɪ
þiubjo	θɪuβjo
þiuda	θɪuða
þiudangardi	θɪuðanɡardɪ
þiudanon	θɪuðanon
miþþiudanon	mɪθːɪuðanon
þiudans	θɪuðans
þiudinassus	θɪuðɪnasːus
þiudisko	θɪuðɪsko
þiufs	θɪuɸs
þiumagus	θɪumaɣus
þius	θɪus
þiuþ	θɪuθ
þiuþeigs	θɪuθiɣs
þiuþeins	θɪuθins
þiuqiss	θɪukʷɪsː
þiuþjan	θɪuθjan
gaþiuþjan	ɡaθɪuθjan
unþiuþjan	unθɪuθjan
þiwadw	θɪwaðw
anaþiwan	anaθɪwan
gaþiwan	ɡaθɪwan
þiwi	θɪwɪ
þlahsjan	θlahsjan
gaþlahsnan	ɡaθlahsnan
gaþláihan	ɡaθlɛhan
þlaqus	θlakʷus
þlauhs	θlɔhs
þliuhan	θlɪuhan
afþliuhan	aɸθlɪuhan
gaþliuhan	ɡaθlɪuhan
unþaþliuhan	unθaθlɪuhan
Þomas	θomas
þrafsteins	θraɸstins
þrafstjan	θraɸstjan
anaþrafstjan	anaθraɸstjan
gaþrafstjan	ɡaθraɸstjan
þragjan	θraɣjan
biþragjan	bɪθraɣjan
þramstei	θramsti
þrasabalþei	θrasaβalθi
þreihan	θrihan
gaþreihan	ɡaθrihan
þreihsl	θrihsl̥
þreis	θris
þridja	θrɪðja
þriskan	θrɪskan
usþriutan	usθrɪutan
þroþjan	θroθjan
usþroþjan	usθroθjan
þrūtsfill	θrutsɸɪlː
þrutsfills	θrutsɸɪlːs
þu	θu
þuei	θui
þugkjan	θuŋkjan
þuhtus	θuhtus
þulains	θulɛns
þulan	θulan
gaþulan	ɡaθulan
usþulan	usθulan
þūsundi	θusundɪ
þusundifaþs	θusundɪɸaθs
þuthaurn	θuthɔrn̥
þuthaurnjan	θuthɔrnjan
þwahan	θwahan
afþwahan	aɸθwahan
biþwahan	bɪθwahan
usþwahan	usθwahan
þwahl	θwahl̥
þwairhei	θwɛrhi
þwairhs	θwɛrhs
þwastiþa	θwastɪθa
gaþwastjan	ɡaθwastjan
þwmiama	θwmɪama
u	u
ubils	uβɪls
ubiltojis	uβɪltojɪs
ubilwaurdjan	uβɪlwɔrdjan
ubilwaurds	uβɪlwɔrds
ubizwa	uβɪzwa
uf	uɸ
ufaiþeis	uɸɛθis
ufar	uɸar
ufarassjan	uɸarasːjan
ufarassus	uɸarasːus
ufarfullei	uɸarɸulːi
ufarfulls	uɸarɸulːs
ufargudja	uɸarɡuðja
ufarhauseins	uɸarhɔsins
ufarhiminakunds	uɸarhɪmɪnakunds
ufarjaina	uɸarjɛna
ufarmaudei	uɸarmɔði
ufarmeleins	uɸarmelins
ufarmeli	uɸarmelɪ
ufaro	uɸaro
ufarranneins	uɸarːanːins
ufarskafts	uɸarskaɸts
ufarswara	uɸarswara
ufhauseins	uɸhɔsins
ufhnaiweins	uɸhnɛwins
Ufitahari	uɸɪtaharɪ
ufjo	uɸjo
ufkunþi	uɸkunθɪ
ufswalleins	uɸswalːins
ufta	uɸta
ufto	uɸto
ufwaira	uɸwɛra
ugkis	uŋkɪs
uh	uh
uhtedun	uhteðun
uhteigs	uhtiɣs
uhteigo	uhtiɣo
uhtiugs	uhtɪuɣs
uhtwo	uhtwo
ulbandus	ulbandus
unagands	unaɣands
unagein	unaɣin
unairkns	unɛrkn̥s
unaiwisks	unɛwɪsks
unanasiuniba	unanasɪunɪβa
unandhuliþs	unandhulɪθs
unandsakans	unandsakans
unandsoks	unandsoks
unatgāhts	unatɡahts
unbairands	unbɛrands
unbarnahs	unbarnahs
unbaurans	unbɔrans
unbeistei	unbisti
unbeistjoþs	unbistjoθs
unbiari	unbɪarɪ
unbilaistiþs	unbɪlɛstɪθs
unbimait	unbɪmɛt
unbimaitans	unbɪmɛtans
unbrūks	unbruks
und	und
undar	undar
undaristo	undarɪsto
undarleija	undarlija
undaro	undaro
undaurnimats	undɔrnɪmats
undiwanei	undɪwani
unfagrs	unɸaɣr̥s
unfairina	unɸɛrɪna
unfairinodaba	unɸɛrɪnoðaβa
unfairlaistiþs	unɸɛrlɛstɪθs
unfaurs	unɸɔrs
unfaurweis	unɸɔrwis
unfraþjands	unɸraθjands
unfreideins	unɸriðins
unfrodei	unɸroði
unfroþs	unɸroθs
ungafairinonds	unɡaɸɛrɪnonds
ungafairinoþs	unɡaɸɛrɪnoθs
ungahabands	unɡahaβands
ungahobains	unɡahoβɛns
ungaƕairbs	unɡaʍɛrbs
ungakusans	unɡakusans
ungalaubeins	unɡalɔβins
ungalaubjands	unɡalɔβjands
ungalaufs	unɡalɔɸs
ungaraihtei	unɡarɛhti
ungasaiƕans	unɡasɛʍans
ungastoþs	unɡastoθs
ungatass	unɡatasː
ungatewiþs	unɡatewɪθs
ungawagiþs	unɡawaɣɪθs
unhabands	unhaβands
unhaili	unhɛlɪ
unhails	unhɛls
unhanduwaurhts	unhanduwɔrhts
unhindarweis	unhɪndarwis
unhrainei	unhrɛni
unhrainiþa	unhrɛnɪθa
unhrains	unhrɛns
unhulþa	unhulθa
unhulþo	unhulθo
unhunslags	unhunslaɣs
unƕapnands	unʍapnands
unƕeila	unʍila
unkarja	unkarja
unkaureins	unkɔrins
unkja	unkja
unkunnands	unkunːands
unkunþi	unkunθɪ
unkunþs	unkunθs
unledi	unleðɪ
unleþs	unleθs
unliufs	unlɪuɸs
unliugaiþs	unlɪuɣɛθs
unliugands	unlɪuɣands
unliuts	unlɪuts
unlustus	unlustus
unmahteigs	unmahtiɣs
unmahts	unmahts
unmanariggwai	unmanarɪɡɡwɛ
unmanwus	unmanwus
unmildjai	unmɪldjɛ
unnutjans	unːutjans
unqeniþs	unkʷenɪθs
unqeþs	unkʷeθs
unriurei	unrɪuri
unriureis	unrɪuris
unriurs	unrɪurs
unrodjands	unroðjands
unsahtaba	unsahtaβa
unsaiƕands	unsɛʍands
unsaltans	unsaltans
unsar	unsar
unselei	unseli
unsels	unsels
unsibjis	unsɪβjɪs
unskaus	unskɔs
unsuti	unsutɪ
unsweibands	unswiβands
unswerei	unsweri
unsweriþa	unswerɪθa
unswers	unswers
unswikunþs	unswɪkunθs
untals	untals
unte	unte
untilamalsks	untɪlamalsks
untriggws	untrɪɡɡws
unþiuda	unθɪuða
unþiuþ	unθɪuθ
unþwahans	unθwahans
unufbrikands	unuɸbrɪkands
unuhteigo	unuhtiɣo
unuslaisiþs	unuslɛsɪθs
unusspilloþs	unusːpɪlːoθs
unwahs	unwahs
unwairþaba	unwɛrθaβa
unwammei	unwamːi
unwamms	unwamːs
unwaurstwo	unwɔrstwo
unweis	unwis
unweniggo	unwenɪŋɡo
unwerein	unwerin
unwiss	unwɪsː
unwita	unwɪta
unwitands	unwɪtands
unwiti	unwɪtɪ
unwunands	unwunands
ur	ur
urrists	urːɪsts
urrugks	urːuŋks
urruns	urːuns
urruns	urːuns
us	us
usbalþei	usbalθi
usbeisnei	usbisni
usbeisneigs	usbisniɣs
usbeisns	usbisn̥s
usbloteins	usblotins
usdaudei	usdɔði
usdauþs	usdɔθs
usdaudoza	usdɔðoza
usdaudo	usdɔðo
usdrusts	usdrusts
usfairina	usɸɛrɪna
usfarþo	usɸarθo
usfilh	usɸɪlh
usfilma	usɸɪlma
usfilmei	usɸɪlmi
usfodeins	usɸoðins
usfulleins	usɸulːins
usgrudja	usɡruðja
ushaista	ushɛsta
uskunþs	uskunθs
uslauseins	uslɔsins
usliþa	uslɪθa
uslukns	uslukn̥s
usluk	usluk
usluneins	uslunins
usmet	usmet
usqiss	uskʷɪsː
ussateins	usːatins
ussindo	usːɪndo
usskawai	usːkawɛ
usstass	usːtasː
usstiurei	usːtɪuri
usstiuriba	usːtɪurɪβa
ustaikneins	ustɛknins
ustauhts	ustɔhts
usþroþeins	usθroθins
usþulains	usθulɛns
uswahsans	uswahsans
uswahsts	uswahsts
uswalteins	uswaltins
uswandi	uswandɪ
uswaurhts	uswɔrhts
uswaurhts	uswɔrhts
uswaurpa	uswɔrpa
usweihs	uswihs
uswena	uswena
uswiss	uswɪsː
uswissi	uswɪsːɪ
ūt	ut
ūta	uta
ūtana	utana
ūtaþro	utaθro
uzeta	uzeta
uzu	uzu
wadi	waðɪ
wadjabokos	waðjaβokos
gawadjon	ɡawaðjon
waggarja	waŋɡarja
waggs	waŋɡs
wagjan	waɣjan
afwagjan	aɸwaɣjan
gawagjan	ɡawaɣjan
inwagjan	ɪnwaɣjan
uswagjan	uswaɣjan
wahsjan	wahsjan
ufarwahsjan	uɸarwahsjan
uswahsjan	uswahsjan
wahstus	wahstus
wahtwom	wahtwom
wai	wɛ
waian	wɛan
biwaibjan	bɪwɛβjan
waidedja	wɛðeðja
waihjo	wɛhjo
waihsta	wɛhsta
waihstastains	wɛhstastɛns
waiht	wɛht
waihts	wɛhts
wáila	wɛla
wailadeþs	wɛlaðeθs
wailamerei	wɛlameri
wailamereins	wɛlamerins
wailamereis	wɛlameris
wailaqiss	wɛlakʷɪsː
wailawizns	wɛlawɪzn̥s
wainahs	wɛnahs
wainei	wɛni
faurwaipjan	ɸɔrwɛpjan
waips	wɛps
wair	wɛr
wairaleiko	wɛraliko
wairdus	wɛrdus
wairilom	wɛrɪlom
wairpan	wɛrpan
afwairpan	aɸwɛrpan
atwairpan	atwɛrpan
frawairpan	ɸrawɛrpan
gawairpan	ɡawɛrpan
innwairpan	ɪnːwɛrpan
uswairpan	uswɛrpan
wairs	wɛrs
wairsiza	wɛrsɪza
wairþ	wɛrθ
wairþan	wɛrθan
frawairþan	ɸrawɛrθan
wairþida	wɛrθɪða
gagáwairþjan	ɡaɣawɛrθjan
gagáwairþnan	ɡaɣawɛrθnan
wairþon	wɛrθon
wairþs	wɛrθs
wait	wɛt
waitei	wɛti
wajamerei	wajameri
wajamereins	wajamerins
wakan	wakan
þairhwakan	θɛrhwakan
uswakjan	uswakjan
gawaknan	ɡawaknan
waldan	waldan
gawaldan	ɡawaldan
waldufni	walduɸnɪ
walisa	walɪsa
waljan	waljan
gawaljan	ɡawaljan
waltjan	waltjan
uswaltjan	uswaltjan
uswalugjan	uswaluɣjan
walus	walus
walwison	walwɪson
afwalwjan	aɸwalwjan
atwalwjan	atwalwjan
faurwalwjan	ɸɔrwalwjan
wamba	wamba
wamme	wamːe
anawammjan	anawamːjan
wan	wan
wanains	wanɛns
wandjan	wandjan
afwandjan	aɸwandjan
atwandjan	atwandjan
biwandjan	bɪwandjan
gawandjan	ɡawandjan
inwandjan	ɪnwandjan
uswandjan	uswandjan
wandus	wandus
waninassus	wanɪnasːus
wans	wans
wardja	wardja
frawardjan	ɸrawardjan
warei	wari
wargiþa	warɡɪθa
gawargjan	ɡawarɡjan
warjan	warjan
warmjan	warmjan
warai	warɛ
wasjan	wasjan
andwasjan	andwasjan
gawasjan	ɡawasjan
wasti	wastɪ
wato	wato
waurd	wɔrd
waurdahs	wɔrdahs
waurdajiuka	wɔrdajɪuka
andwaurdjan	andwɔrdjan
filuwaurdjan	ɸɪluwɔrdjan
ubilwaurdjan	uβɪlwɔrdjan
waurkjan	wɔrkjan
fairwaurkjan	ɸɛrwɔrkjan
frawaurkjan	ɸrawɔrkjan
gawaurkjan	ɡawɔrkjan
uswaurkjan	uswɔrkjan
waurms	wɔrm̥s
waurstw	wɔrstw
waurstwa	wɔrstwa
waurstwei	wɔrstwi
waurstweigs	wɔrstwiɣs
waurstwja	wɔrstwja
waurts	wɔrts
wegs	weɣs
weiha	wiha
weihan	wihan
andwaihan	andwɛhan
weihan	wihan
gaweihan	ɡawihan
weihiþa	wihɪθa
weihnan	wihnan
weihs	wihs
weihs	wihs
wein	win
weinabasi	winaβasɪ
weinagards	winaɣards
weinatains	winatɛns
weinatriu	winatrɪu
weindrugkja	windruŋkja
weinnas	winːas
weipan	wipan
weis	wis
fullaweisjan	ɸulːawisjan
gafullaweisjan	ɡaɸulːawisjan
gaweison	ɡawison
fraweitan	ɸrawitan
inweitan	ɪnwitan
fairweitjan	ɸɛrwitjan
idweitjan	ɪðwitjan
weitwodei	witwoði
weitwodeins	witwoðins
weitwodi	witwoðɪ
weitwodiþa	witwoðɪθa
weitwodjan	witwoðjan
miþweitwodjan	mɪθwitwoðjan
weitwoþs	witwoθs
wenjan	wenjan
faurawenjan	ɸɔrawenjan
gawenjan	ɡawenjan
wens	wens
wepna	wepna
Wereka	wereka
tuzwerjan	tuzwerjan
unwerjan	unwerjan
gawidan	ɡawɪðan
inwidan	ɪnwɪðan
widuwairna	wɪðuwɛrna
widuwo	wɪðuwo
wigadeinom	wɪɣaðinom
gawigan	ɡawɪɣan
wigana	wɪɣana
wigs	wɪɣs
wiko	wɪko
wilja	wɪlja
wiljahalþei	wɪljahalθi
wiljan	wɪljan
Wiljariþ	wɪljarɪθ
wilþeis	wɪlθis
wilwa	wɪlwa
wilwan	wɪlwan
diswilwan	dɪswɪlwan
frawilwan	ɸrawɪlwan
biwindan	bɪwɪndan
dugawindan	duɣawɪndan
uswindan	uswɪndan
winds	wɪnds
winja	wɪnja
winna	wɪnːa
winnan	wɪnːan
gawinnan	ɡawɪnːan
winno	wɪnːo
wintrus	wɪntrus
winþiskauro	wɪnθɪskɔro
diswinþjan	dɪswɪnθjan
wipja	wɪpja
wis	wɪs
wisan	wɪsan
atwisan	atwɪsan
faurawisan	ɸɔrawɪsan
frawisan	ɸrawɪsan
inwisan	ɪnwɪsan
miþwisan	mɪθwɪsan
ufarwisan	uɸarwɪsan
wisan	wɪsan
biwisan	bɪwɪsan
wisan	wɪsan
gawisan	ɡawɪsan
miþgawisan	mɪθɡawɪsan
þairhwisan	θɛrhwɪsan
wists	wɪsts
wit	wɪt
witan	wɪtan
miþwitan	mɪθwɪtan
witan	wɪtan
witodafasteis	wɪtoðaɸastis
witodalaisareis	wɪtoðalɛsaris
witodalaus	wɪtoðalɔs
witodeigo	wɪtoðiɣo
witoþ	wɪtoθ
witubni	wɪtuβnɪ
wiþon	wɪθon
wiþra	wɪθra
wiþrawairþs	wɪθrawɛrθs
wiþrus	wɪθrus
wizon	wɪzon
wlaiton	wlɛton
wlits	wlɪts
wlizjan	wlɪzjan
Wmainaius	wmɛnɛus
wokains	wokɛns
wokra	wokra
wopjan	wopjan
atwopjan	atwopjan
ufwopjan	uɸwopjan
woþeis	woθis
woþs	woθs
wraiqs	wrɛkʷs
wraka	wraka
wrakja	wrakja
wrakjan	wrakjan
wraks	wraks
wratodus	wratoðus
wraton	wraton
wrekei	wreki
wreþus	wreθus
wrikan	wrɪkan
frawrikan	ɸrawrɪkan
gawrikan	ɡawrɪkan
gawrisqan	ɡawrɪskʷan
writs	wrɪts
wriþus	wrɪθus
wrohjan	wrohjan
frawrohjan	ɸrawrohjan
wrohs	wrohs
wruggo	wruŋɡo
wulan	wulan
wulfs	wulɸs
wulla	wulːa
wullareis	wulːaris
wulþags	wulθaɣs
wulþriza	wulθrɪza
wulþrs	wulθr̥s
wulþus	wulθus
wulwa	wulwa
gawundon	ɡawundon
wunds	wunds
wundufni	wunduɸnɪ
wunns	wunːs
Xafira	χaɸɪra
Xreskus	χreskus
Xristus	χrɪstus
Zaibaidaius	zɛβɛðɛus
Zakarias	zakarɪas
Zakkaius	zakːɛus
Zauraubabil	zɔrɔβaβɪl
Zaxxaius	zaχːɛus
Zelotes	zelotes
