form	sense
†Aai	†Aai
aba	Ehemann
abba	Vater
Abeileni	Abeileni
Abia*	Abia*
Abiaþar	Abiaþar
Abraham	Abraham
bi-abrjan	vor Furcht, Staunen außer sich geraten über
abrs	stark, heftig
abraba	sehr
abu	von, von __ weg, von __ her
Adam	Adam
Addei*	Addei*
Addin	Addin
Adoneikam*	Adoneikam*
af	von, von __ weg, von __ her
afar	nachher
[afara]	Nachkomme
afardags	der folgende Tag
afarsabbate	des Nachsabbats d.h. des ersten Wochentags
afdauiþs*	geplagt
afdomeins	Verdammung
afdrugkja	Trunkenbold
afetja	Fresser
afgrundiþa	Abgrund
afgudei	Gottlosigkeit
afguþs*	abgöttisch, gottlos
afhaimeis*	der Heimat fern
aflageins	Ablegung, Erlaß
aflet*	Erlaß
afmarzeins	Betrug
afmauiþs*	ermüdet
afsateins	Absetzung
afstass	Abfall
afta	hinten
aftana	von hinten
aftaro	von hinten
aftra	wieder
aftraanastodeins	Wiederanfang, Wiedererneuerung
aftuma	letzter
aftumists	letzter
-agan	furchtlos
Agar	Agar
aggilus	Engel, Bote
aggwiþa	Bedrängnis (Enge)
ga-aggwjan	bedrängen
aggwus	eng
agis	Furcht, Schrecken
af-agjan	ängstigen
in-agjan	einen anfahren
us-agjan	einen erschrecken
aglaitei	Unzucht
aglaitgastalds	schmutzig gewinnsüchtig
aglaiti*	Unzucht
aglaitiwaurdei	Schandrede
agliþa	Drangsal
us-agljan	(ins Gesicht schlagen) bedrängen
aglo	Drangsal
agls	schimpflich
aglus	schwierig
agluba	agluba
Agustus	Agustus
aha	Sinn, Verstand
ahaks	zahme (weiße) Taube
ahana	Spreu
Aharon	Aharon
ahjan	meinen
ahma	Geist
ahmateins	Inspiration
ahmeins	geistig, geistlich
ahs	Ähre
ahtau	acht
ahtaudogs	achttägig
ahtautehund	achtzig
ahtuda	der achte
aƕa	Fluß, Gewässer
[Aia]	[Aia]
Aibair	Aibair
†aibr	Opfergabe
Aiddua	Aiddua
Aieira	Aieira
Aifaisius*	Aifaisius*
Aifaiso*	Aifaiso*
aiffaþa	öffne dich
aigan*	haben
fair-aihan	teilhaben an
aigin	Eigentum
ga-aiginon	In Besitz nehmen
aihtron	betteln; für sich verlangen
aihtrons	Gebet
aihts	Eigentum
aiƕatundi	Dornstrauch
af-aikan	leugnen
aikklesjo	Gemeinde, Kirche; Gotteshaus
Ailam	Ailam
Aileiaizair	Aileiaizair
Aileiakeim	Aileiakeim
Aileisabaiþ	Aileisabaiþ
ailoe	ailoe
[Ailul]	[Ailul]
Aimmeira*	Aimmeira*
ainabaur	eingeboren
ainaha	einzig
ainakls	vereinzelt, alleinstehend
ainamundiþa	Einheit, Einmütigkeit
[ga-ainan]	vereinzeln, trennen
ainfalþei	Einfalt
ainfalþs	einfach
ainfalþaba	einfältig
ainƕarjizuh	ein jeder
ainƕaþaruh*	jeder von beiden
ainlif*	elf
Ainnaa	Ainnaa
Ainok	Ainok
Ainos	Ainos
ains	ains
ainshun	niemand, keiner
Aiodia	Aiodia
Aipafras	Aipafras
Aipafraudeitus	Aipafraudeitus
aipiskaupei*	Bischofsamt
aipiskaupus	Bischof
aipistaule	Brief
áir	früh
airis	längst, eher
Airastus	Airastus
airinon	Gesandter sein, unterhandeln
áirizans	Vorfahren
[airkns]	heilig
airkniþa	Lauterkeit, Echtheit
Airmodam	Airmodam
Airmogaineis	Airmogaineis
airþa	Erde, Land
airþakunds	von irdischer Abkunft
airþeins	irdisch
airus	Bote
airzei	Irrlehre
airzeis*	irre geführt
airziþa	Irrlehre
airzjan	irre führen
af-airzjan	irre machen
aistan	sich scheuen vor
ga-aistan	sich scheuen vor
aiþei	Mutter
aiþs	Eid
aiþþau	oder
aiwaggeli	Evangelium
aiwaggelista	aiwaggelista
aiwaggeljan	das Evangelium verkünden
aiwaggeljo	Evangelium
aiweins	ewig
aiwiski	Schande
aiwiskon	schändlich handeln
ga-aiwiskon	beschämen, beschimpfen
us-aiwjan	sich anstrengen
aiwlaugia	Segen (Spende)
Aiwneikai	Aiwneikai
aiws	Zeit, Ewigkeit
Aiwwa	Aiwwa
aiwxaristia	Dank
aiz	Erz(münze)
Aizaikeia	Aizaikeia
aizasmiþa	Erzschmied
Aizleim	Aizleim
Aizor	Aizor
ajukdūþs*	Ewigkeit
ak	sondern
Akaja	Akaja
Akajus*	Akajus*
Akaïkus	Akaïkus
akei	aber
aket*	Essig
akran	Frucht
akranalaus	unfruchtbar
akrs	Acker
Akwla	Akwla
alabalstraun	Salbenbüchse aus Alabaster
alabrunsts	Brandopfer
Alaiksandrus	Alaiksandrus
alakjo	insgesamt
alamans*	Gesamtheit der Menschen
alamannans*	alamannans*
Alamod	Alamod
alan	wachsen
alaþarba	an allem Mangel leidend
aldomin	Alter
alds	Menschenalter, Zeit
aleina	Elle
alew*	Öl
alewabagms	Ölbaum
alewja	Öl
Alfaius	Alfaius
alhs	Tempel
alja	außer
aljakuns	anderswoher stammend
aljaleiko	anders
aljaleikos	anders
[aljaleikoþs]	anders gebildet, allegorisch
aljan	mästen
aljan	Eifer
aljanon	eifern
in-aljanon	zornig machen
aljar	anderswo
aljaþ	anderswohin
aljaþro	anderswoher
aljis*	ein andrer
allandjo	völlig
allaþro	von allen Seiten her
allawaurstwa	vollkommen
allawerei	Redlichkeit
allis	überhaupt
alls	all, jeder, ganz
allwaldands	Allmächtiger
us-alþan	alt werden
alþeis	alt
[Alul]	[Alul]
Ameinadab*	Ameinadab*
amen	amen
Ammo*	Ammo*
ams*	Schulter
amsa*	amsa*
an	denn, nun
ana	darauf, außerdem
anabusns	Gebot
anafilh	Empfehlung, Überlieferung
anahaimeis*	in der Heimat befindlich
anaks	plötzlich
anakunnains	Lesung
analageins	Auflegung
analaugnei	Verborgenheit
analaugns	verborgen
analeiko	auf gleiche Weise
anamahts	Übermacht, Mißhandlung
anaminds	versteckte Meinung, vermutung
uz-anan	ausatmen
Ananias*	Ananias*
Ananeias*	Ananeias*
ananiujiþa*	Erneuerung
anaqal	Ruhe
anaqiss	Lästerung
anasiuns	sichtbar
anastodeins	Anfang
anaþaima	anaþaima
Anaþoþ	Anaþoþ
anawairþs	zukünftig
anawiljei	Billigkeit
and	entlang, über __ hin, auf __ hin
andabauhts	Lösegeld
andabeit	Tadel
andahafts	Antwort; Verteidigung
andahait	Bekenntnis
andalauni	Gegenlohn; Vergeltung
andanahti	Abend
andaneiþa	feindlich
andanem	das Empfangen
andanemeigs	festhaltend
andanems	angenehm
andanumts	Aufnahme, Annahme; Erhebung
andasets	verabscheuungswert
andastaþjis	Widersacher
andastaua	Gegner vor Gericht
andaþāhts	nüchtern, verständig
andaugi	Antlitz
andaugiba	freimütig, offen
andaugjo	offen
andawairþi	Preis
andawaurdi	Antwort
andawizns	Sold; Notdurft
andawleizn*	Angesicht
andbahti	Amt, Dienst
andbahtjan	etwas (Akk.) leisten
andbahts	Diener
andeis	Ende
andhuleins	Enthüllung, Offenbarung
andilaus	endlos
andizuh	anders, sonst
Andraias	Andraias
andstald*	Darbietung, Beistand
andwairþi	Gegenwart, Angesicht, Person
andwairþs	gegenwärtig
Anna	Anna
Annas	Annas
anno*	Sold
Ano*	Ano*
ans*	Balken
ansteigs	gnädig
ansts	Freude; Dank; Gnade, Gunst
Antiaukia*, Antiokia*	Antiaukia*, Antiokia*
anþar	anderer, zweiter
anþarleikei	Verschiedenheit
anþarleiko	anders
Appaullo*	Appaullo*
apaustaulei	Apostolat
apaustaulus	Apostel
aqizi	Axt
ara	Aar
Arabia	Arabia
Araita*	Araita*
Aram	Aram
arbaidjan	arbeiten; dulden
bi-arbaidjan	seine Ehre setzen in, trachten nach
miþ-arbaidjan	mit Jem. arbeiten; mit Jem. leiden
þairh-arbaidjan	dúrcharbeiten
arbaiþs	Arbeit, Drangsal
arbi	das Erbe
arbinumja	der Erbe
arbja	der Erbe
arbjo	Erbin
Areimaþaia	Areimaþaia
Areistarkus	Areistarkus
Arfaksad*	Arfaksad*
arƕazna	Pfeil
arjan	pflügen
arka	hölzerner Kasten, Arche; Futteral, Beutel
arkaggilus	Erzengel
Arkippus	Arkippus
armahairtei	Barmherzigkeit
armahairtiþa	Almosen
armahairts	barmherzig
armaio	Barmherzigkeit
arman	sich eines erbarmen
ga-arman	sich eines erbarmen
arms*	arm, beklagenswert
arms	Arm
arniba	sicher
aromata	aromata
[Artaksairksus]	[Artaksairksus]
arwjo	umsonst
Asaf*	Asaf*
asans	Sommer
Aser*	Aser*
Asgad*	Asgad*
Asia	Asia
asiluqairnus	Eselsmühle
asilus	Esel
Asmoþ	Asmoþ
asneis	Mietling, Tagelöhner
assarjus*	Aß, Pfennig
Assaum	Assaum
astaþ	Sicherheit
asts	Ast
at	von
ataþni*	Jahr
Ater*, Ateir*	Ater*, Ateir*
atgagg*	Zugang
atisk	Saat
fra-atjan	zum Essen austeilen
atta	Vater
atwitains*	das Beobachten
Aþeinim	Aþeinim
aþnam	Jahre
aþþan	aber doch
audagei	Seligkeit
audagjan	selig preisen
audags	selig
audahafts	beglückt
aufto	allerdings; wohl; vielleicht
augadauro	Fenster
augjan	zeigen
at-augjan	einem (Dat.) etwas (Akk.) zeigen
augo	Auge
auhjodus	Lärm
auhjon	lärmen
auhns*	Ofen
auhsa	Ochse
auhsus	Ochse
auhuma	höher
auhumists	höchster
auk	denn, nämlich
aukan	sich mehren
ana-aukan	hinzufügen zu
bi-aukan	hinzufügen
ga-aukan	sich vermehren, zunehmen
auknan	sich mehren
bi-auknan	sich vermehren, zunehmen
Auneiseifaurus	Auneiseifaurus
Aunisimus	Aunisimus
aurahjom	Grabdenkmäler, Gräber
aurali*	Schweißtuch
aurkjus*	Krug
aurkeis*	aurkeis*
aurtigards	Garten
aurtja	Landmann, Winzer
auso	Ohr
auþida	Wüste
auþeis*	öde
auþs*	auþs*
aweþi	Schafherde
awiliudon	einem (Dat.) danken
awiliuþ	Dank
awistr*	Schafstall
awo	Großmutter
Axaïa	Axaïa
azetjam	üppig lebend
azets*	leicht
azgo	Asche
azwme	am Tage der ungesäuerten Brode
-ba	wenn
Babawis	Babawis
badi	Bett
Bagauis	Bagauis
bagms	Baum
bai	beide
Baiailzaibul	Baiailzaibul
baidjan	einen (Akk.) zwingen
ga-baidjan	einen (Akk.) zwingen
Baidsaiïdan	Baidsaiïdan
Bailiam	Bailiam
Bainiamein	Bainiamein
bairabagms	Maulbeerbaum
bairan	tragen (leiden)
at-bairan	bringen
inn-atbairan	hineinbringen
fra-bairan	vertragen
ga-bairan	vergleichen
þairh-bairan	hindurchtragen
us-bairan	hinaustragen; hervorbringen; vorbringen d.i. antworten; ertragen
ūt-bairan	hinaustragen
Bairauja	Beroia in Thrakien
bairgahei	Gebirgsgegend
bairgan	einen bergen, bewahren
ga-bairgan	einen bergen, bewahren
bairhtei	Helle
bairhtjan	offenbaren
ga-bairhtjan	offenbaren
bairhts	hell, offenbar
bairhtaba	offen
baitrei	Bitterkeit
baitrs	bitter
Baiþil	Baiþil
[Baiþlaem]	[Baiþlaem]
Baiþsaïdan	Baiþsaïdan
bajoþs	beide
balgs	Schlauch
†balsagga	Hals, Nacken
balsan	Salbe
balþaba	kühn, freimütig
balþei	Kühnheit, Freimut
balþjan	kühn sein, wagen
balwawesei	Bosheit
balweins	Pein; Strafe; Folter
balwjan	martern
Banauis	Banauis
bandi	Band, Fessel
bandja	Gefangener
bandwa	Zeichen
bandwjan	ein Zeichen, einen Wink geben, andeuten
ga-bandwjan	durch Winke andeuten
bandwo	Zeichen
banja*	Schlag, Wunde
bansts	Scheuer
Barabba(s)	Barabba(s)
Barakeias*	Barakeias*
barbarus	Nicht
barizeins	von Gerste bereitet
barms	Busen, Schoß
barn	Kind
Barnabas	Barnabas
barnilo	Kindlein
barniskei	kindliches Wesen
barniski	Kindheit
barnisks	kindlich
Barteimaiaus	Barteimaiaus
Barþaulaumaius	Barþaulaumaius
barusnjan	fromm verehren
Bassus*	Bassus*
batiza	besser
batista	batista
ga-batnan	Vorteil erlangen
Batwins*	Batwins*
bauains	Wohnung
bauan	wohnen, bewohnen
ga-bauan	Wohnung aufschlagen
Bauanairgais	Bauanairgais
Bauauz*	Bauauz*
us-baugjan	ausfegen
uf-bauljan	aufblasen
baur	der Geborene
baurgja	Bürger
baurgs	Turm, Burg; Stadt
baurgswaddjus	Stadtmauer
baurþei	Bürde
bauþs	stumm
beidan	auf etwas warten
ga-beidan	ausharren, ertragen
us-beidan	erwarten
beist	Sauerteig
ga-beistjan	durchsäuern
beitan	beißen
and-beitan	schelten, bedrohen
Beroþ	Beroþ
berusjos	Eltern
Beþania	Beþania
Beþlaihaim	Beþlaihaim
Beþsaeida	Beþsaeida
Beþsfagei	Beþsfagei
bi	bei, um
bibaurgeins	Lager
bida	Bitte, Gebet; Anliegen, Aufforderung
bidagwa	Bettler
bidjan	bitten, beten, betteln
ga-bidjan	beten, bitten
us-bidan	erbitten
bifaih	Übervorteilung
bifaihon	Übervorteilung
bihait	üble Nachrede
bihaitja	Prahler
biƕe	woran
bijands	zugleich aber rüste auch
bimait	Beschneidung
bindan	einen mit etwas (Dat.) binden
and-bindan	lösen; auflösen, erklären; entbinden von
bi-bindan	umbinden mit (Dat.)
ga-bindan	binden
bireikei	Gefahr
birekjai	in Gefahr kommen
birodeins	Murren; Verleumdungen
birūnains	Nachstellung, Anschlag
birusjos	Eltern
bisauleins	Befleckung
bistug(g)q	Anstoß
bisunjane	ringsum
biþe	nachher, später
ana-biudan	entbieten, befehlen
faur-biudan	verbieten
biugan	beugen; sich beugen
ga-biugan	beugen
biuhti	Gewohnheit
biuhts	gewohnt
biuþs*	Tisch
blandan	sich vermischen mit
blauþjan	abschaffen
ga-blauþjan	abschaffen
bleiþei	Wohlwollen, Güte
bleiþjan	barmherzig sein
ga-bleiþjan	sich erbarmen
bleiþs	barmherzig; dem Guten zugetan
uf-blesan	aufblasen
bliggwan	schlagen
us-bliggwan	durchbleuen
ga-blindjan	verblenden
af-blindnan	erblinden
blinds	blind
bloma*	Blume
blotan	verehren
blotinassus	Verehrung
bloþ	Blut
bloþarinnandei	blutflüssig
bnauan	reiben, zerreiben
boka	Buchstabe
bokareis	Schriftgelehrter; Schreiber
bota	Nutzen
botjan	nützen, bessern
ga-botjan	verbessern, herstellen
braƕa	im Augenblick
braidei	Breite
us-braidjan	ausbreiten nach
braiþs	breit
brakja	Ringen, Ringkampf
ga-brannjan	verbrennen
in-brannjan	in Brand stecken
briggan	bringen
brikan	brechen; zerstören
ga-brikan	zerbrechen
uf-brikan	verwerfen, verachten
brinnan	brennen
uf-brinnan	verbrennen
brinno	Fieber
broþar	Bruder
broþrahans	Brüder
broþrulubo	Bruderliebe
brūkjan	gebrauchen
us-bruknan	ausgebrochen werden
brūks	brauchbar
brunjo	Brustharnisch
brunna	Brunnen
brusts	Brust
brūþfaþs	Bräutigam
brūþs	Neuvermählte, Schwiegertochter
bugjan	kaufen
fra-bugjan	verkaufen für
us-bugjan	erkaufen
and-bundnan	entbunden werden
bwssaun	feines Linnen
ga-daban	was ihm bevorstand
daddjan	säugen
dags	Tag
daigs	Teig
Daikapaulis*	Daikapaulis*
daila	Teilnahme, Gemeinschaft
dailjan	teilen, zuteilen, mitteilen
af-dailjan	abteilen, einen Teil abgeben (Akk.)
dis-dailjan	verteilen, zerteilen
fra-dailjan	verteilen unter (Dat.)
ga-dailjan	zuteilen, zerteilen
dails	Teil
daimonareis	Besessener
dals*	Grube; Schlucht, Tal
dalaþ	zu Tal, abwärts, nieder; auf die Erde
dalaþa	unten
dalaþro	von unten, unten
Dalmatia	Dalmatia
Damaskon	Damaskon
faur-dammjan	verdämmen, versperren
daubei	Taubheit
daubiþa	Taubheit
ga-daubjan	verstocken
af-daubnan	ertauben, verstockt werden
us-daudjan	sich beeifern
daufs	taub, verstockt
dauhtar	Tochter
dauhts	Bewirtung
af-dauiþs*	geschunden, geplagt
dauns	Geruch
daupeins	Abwaschung
daupjan	taufen
uf-daupjan	taufen
daupjands	Täufer
daur	(einflügeliges) Tor
daurawarda	Türhüterin
daurawardo	Türhüterin
daurawards	Türhüter
Dauriþaius*	Dauriþaius*
daurons	(zweiflügeliges) Tor, Tür
ga-daursan	sich erkühnen, wagen
dauþeins	das Absterben
dauþjan	töten
af-dauþjan	töten
ga-dauþjan	Tod bringen, töten
ga-dauþnan	sterben
miþ-gadauþnan	mit sterben
dauþs	tot
dauþubleis*	zum Tode bestimmt
dauþus	Tod
Daweid	Daweid
Demas	Demas
diabula	Verleumderin
diabaulus	Teufel
diabulus	diabulus
diakaunus	Diakon
Didimus	Didimus
digan	kneten, aus Ton bilden
ga-digan	kneten, aus Ton bilden
digrei	Fülle
distaheins*	Zerstreuung
diswiss	Auflösung d.i. Abmarsch, das Scheiden
diupei	Tiefe
diupiþa	Tiefe
ga-diupjan	vertiefen
diups	tief
dius*	wildes Tier
diwan	sterben
af-dobnan	af-dobnan
af-dojan*	geplagt
domjan	urteilen, beurteilen
af-domjan	beurteilen, verurteilen
bi-domjan	verurteilen
ga-domjan	urteilen, entscheiden
doms*	Ruhm
ga-draban	aushauen
†dragan	tragen
ga-dragan	zusammentragen
dragk	Trank
dragkjan	tränken mit
ga-dragkjan	tränken
draibjan	treiben; plagen
drakma*	Drachme
drauhsnos	Brocken; Brosamen
drauhtinassus	Feldzug
drauhtinon	Kriegsdienste tun, zu Felde ziehn
drauhtiwitoþ	Feldzug
af-drausjan	hinabstürzen
ga-drausjan	hinabstürzen
drausnos	Brocken; Brosamen
dreiban	treiben
us-dreiban	austreiben, vertreiben
drigkan	etwas trinken
ana-drigkan	sich antrinken, betrinken
ga-drigkan	trinken
driugan	zu Felde ziehen
driusan	fallen
at-driusan	fallen in
dis-driusan	einen (Akk.) befallen
ga-driusan	hinfallen
us-driusan	herausfallen
driuso	Abhang
drobjan	trüben; irre machen; aufwiegeln
drobna	Aufruhr
drobnan	unruhig werden
ga-drobnan	in Bestürzung geraten
in-drobnan	in Bestürzung geraten
drugkanei	Trunkenheit
drunjus	Schall
drus	Fall
du	du
dugan*	taugen
duƕe	wozu
dulgahaitja	Gläubiger
dulgis	Schuld
dulþjan	ein Fest feiern
dulþs	Fest
af-dumbnan	verstummen
dumbs	stumm
duþe	deshalb, deswegen, dazu
dwalawaurdei	Torenrede
dwaliþa	Torheit
dwalmon	rasen
dwals	töricht
Eeiram	Eeiram
ei	da
Eiaireiko	Eiaireiko
Eikaunion	Eikaunion
eisarn	Eisen
eisarnabandi	Eisenband, Kette
eisarneins	eisern
eiþan	daher somit
†eiþau	†eiþau
Esaïas	Esaïas
Esaw	Esaw
fadar	Vater
[Faddasur]	[Faddasur]
fadrein	Abkunft, Geschlecht, Stamm
fadreins	Geschlecht
faginon	sich freuen über
miþ-faginon	sich mitfreuen
fagrs*	geschickt, geeignet
fāhan	fangen, greifen
ga-fahan	ergreifen, erfassen (auch geistig), ertappen
faheþs	Freude über
fulla-fahjan	Genüge leisten
ga-fahrjan	zubereiten
faian	tadeln
bi-faihon	übervorteilen
ga-faihon	übervorteilen
faihu	Vermögen
faihufrikei	Habsucht
faihufriks	habsüchtig, geldgierig
faihugairnei	Habsucht
faihugairns	geldgierig
faihugawaurki	Erwerb
faihugeiro	Habsucht
faihuskula	Schuldner
faihuþraihna	faihuþraihna
fairguni	Berg
wai-fairƕjan	wehklagen
fairƕus	Welt
fairina	Schuld; Grund; Vorwurf
fairinon	tadeln
fairneis*	alt
fairniþa	Alter
fairns*	vorjährig
fairra	fern
fairraþro	von fern
fairweitl	Schauspiel
fairzna	Ferse
Falaig	Falaig
†Fallasur	†Fallasur
falþan	falten, zusammenrollen
fana	Stück Zeug
fani	Schlamm
Fanuel	Fanuel
Farais*	Farais*
faran	wandern, ziehen
Farao*	Farao*
Fareisaius	Fareisaius
farjan	fahren
at-farjan	einlaufen, landen
fāskja*	Binde
fastan	halten, festhalten; beobachten, bewachen
ga-fastan	behalten, bewahren
fastubni	das Halten, der Dienst
faþa	Zaun
fauho	Fuchs
faur	sie vorzulegen
faura	vor
fauradauri	Straße
faurafilli	Vorhaut
fauragagga*	Hausverwalter
fauragaggi	Verwaltung
fauragaggja	Verwalter
faurahāh	Vorhang
fauramaþleis	Vorsteher, Gebieter
fauramaþli	Oberbefehl
fauratani	Wunderzeichen
faurbauhts	Loskaufung, Erlösung
faurdomeins	Vorurteil
faurhāh	Vorhang
faurhtei	Furcht
faurhtjan	sich fürchten
faurhts	furchtsam
faurlageins	Vorlegung
faurstasseis*	Vorsteher
Faurtunatus	Faurtunatus
faurþis	zuvor, früher
faurþizei	bevor
fawai*	wenige
in-feinan	sich erbarmen
fera	Seite, Gegend
ferja*	Aufpasser
fetjan	schmücken
fian	hasse, verabscheuen
fidurdogs	viertägig
fidurfalþs	vierfältig
fidurragini	das Amt des Vierfürsten
fidwor	vier
fidwortaihun	vierzehn
figgragulþ	Fingerring
figgrs	Finger
fijan	hasse, verabscheuen
fijands	Feind
fijaþwa	Feindschaft
filaus	um vieles, viel
filegri	Höhle
Filetus	Filetus
filhan	verbergen
af-filhan	verbergen vor
ana-filhan	übergeben, überliefern; verpachten; empfehlen
ga-filhan	begraben
us-filhan	begraben
filigri*	Höhle
Filippai	Filippai
Filippisius	Einwohner von Philippi
Filippus	Filippus
filleins	ledern
filu	filu
filudeisei	Arglist
filufáihs	sehr bunt
filugalaufs*	sehr wertvoll
filusna	Vielheit, Menge; Übermaß
filuwaurdei	vieles Reden
filu-waurdjan	viel Worte machen
fimf	fünf
fimftaihun	fimftaihun
fimftataihunda	fünfzehnter
finþan	erkennen, erfahren
fiskja	Fischer
fiskon	fischen
fisks	Fisch
fitan	kreißen, gebären
flahtom	den Flechten
[us-flaugjan]	umgetrieben
flautjan	prahlen
flauts	von eitler Ruhmsucht, prahlerisch
flodus	Strom, Flut
flokan*	betrauern
fodeins	Nahrung
fodjan	nähren, aufziehn
fodr	Scheide
fon	Feuer
fotubandi	Fußfessel
fotubaurd	Fußbank, Schemel
fotus	Fuß
frabauhtaboka	Verkaufsurkunde
fragan	fragen
fragifts	verlobt
fraihnan	fragen
ga-fraihnan	erfragen
fraisan	versuchen
us-fraisan	versuchen
fraistubni	Versuchung
fraiw	Same
fralet*	Erlaß
fralets	Freigelassener
fralusts	Verderben
fram	weiter
framaldrs	im Alter vorgeschritten
framaþeis*	fremd; einer Sache
framaþjan	entfremden
framgāhts*	Fortschritt
framis	weiter
framwairþis	fernerhin
framwigis	fortwährend
[fraqisteins]	Verderb, Vergeudung
frastisibja	Kindschaft
frasts	Kind
us-fratwjan	klug machen
fraþi	Verstand, Sinn
fraþjamarzeins	Verstandestäuschung
fraþjan	denken
fulla-fraþjan	bei (vollem) Verstand sein
frauja	Herr
fraujinassus	Herrschaft
fraujinon	herrschen über
ga-fraujinon	unterjochen
fraujinonds	Herrscher
frawardeins*	Verderben
frawaurhts	sündig
frawaurhts	Sünde
fraweit	Strafe
freidjan	einen schonen
freihals	Freiheit
freis	frei von
friaþwamildjai	zärtlich liebend
frijaþwa	Liebe
frijei	Freiheit
frijon	lieben
frijondi	Freundin
frijonds	Freund
frijons	Kuß
ga-frisahtjan	abbilden
ga-frisahtnan	ein Abbild werden
frisahts	Bild
[Friþareikeis]	Friedrich
ga-friþon	versöhnen mit
friusa	Frost
frodei	Klugheit, Verstand
froþs	klug, verständig
fruma	fruma
frumabaur	Erstgeborener
frumadei	Vorrang
frumisti	Anfang
frumists	frumists
frumist	zuerst
fugls	Vogel
fula	Füllen
fulgins	verborgen
fulhsni	fulhsni
fulla-fahjan	P040.02
fulla-fraþjan	P040.03
fullatojis	vollkommen
fullaweis	vollkommen (weise)
fulla-weisjan	überreden
fullawita	volkommen (an Wissen)
full[e]iþ	des Neumonds
fulljan	füllen
ga-fulljan	mit etw
ufar-fulljan	überfüllen
us-fulljan	erfüllen, vollenden, ersetzen
fullnan	voll werden von
ga-fullnan	erfüllt werden von
us-fullnan	erfüllt werden von
fullo	Fülle, Füllung (was füllt); Flicken
fulls	voll von
fūls	faul
funins, funin	Feuer
funisks	feurig
Fwgailus	Fwgailus
fwnikisks	phönikisch
gaaggwei	Einschränkung
gaarbja	Miterbe
Gabaa	Gabaa
Gabair	Gabair
gabairhteins	Erscheinung
gabaur	Kollekte; Steuer
gabaur*	Festgelage
gabaurgja	Mitbürger
gabaurjaba	gern
gabaurjoþus	Lust
gabaurþiwaurd	Geschlechtsregister
gabaurþs	Geburt
gabei	Reichtum
gabeigs	reich an
gabigjan	reich machen
gabignan	reich sein
gabigs	reich an
gabigaba	reichlich
gabinda	Band
gabindi	Band
gableiþeins	Erbarmen
Gabriel	Gabriel
gabruka	Brocken
gabundi	Band
gadaila	Teilnehmer, Genosse
gadauka*	Hausgenosse
Gaddarenus*	Gaddarenus*
gadeþs*	Tat
[gadigis]	Gebilde
gadiliggs	Vetter
ga-dofs*	es schickt sich für
gadrauhts	Soldat
gafāh*	Fang
gafaurds	Versammlung, hoher Rat
gafaurs	ehrbar; nüchtern, besonnen
gafehaba	anständig
gafeteins	Kleidung
gafilh*	Begräbnis
gafraþjei	Klugheit, Besonnenheit
gafreideins	Erhaltung, Bewahrung
gafrijons	Kuß
gafriþons	Versöhnung
gafulgins	verborgen vor
gagg*	Weg, Straße
gaggan	gehen
af-gaggan	weggehn von
afar-gaggan	nachgehn, folgen
ana-gaggan	kommen
at-gaggan	hinzugehen, kommen
du-atgaggan	hinzukommen zu
inn-atgaggan	hineinkommen
faur-gaggan	vorübergehn
faur-bigaggan	einem vorausgehn
faura-gaggan	vorangehn
ga-gaggan	zusammenkommen
inn-gaggan	hineingehn
miþ-gaggan	mitgehn mit
þairh-gaggan	hindurchgehn, vorübergehn
ufar-gaggan	etw. übertreten
us-gaggan	ausgehn, hinausgehn
ūt-gaggan	hinausgehn, ausgehn
wiþra-gaggan	entgegengehn
gagrefts	Beschluß, Verordnung
gagudei	Frömmigkeit
gaguþs*	anständig, ehrbar
gagudaba	fromm
gahāhjo	im Zusammenhang, der Reihe nach
gahails	ganz unversehrt
gahait	Verheißung
gahauseins	Gehör, (Gehörtes d.i.) Predigt
gahlaiba	Genosse
gahlaifs*	Genosse
[ga-hnipnan]	[ga-hnipnan]
gahobains	Enthaltsamkeit
gahraineins	Reinigung
gahugds	Gesinnung; Sinn; Gewissen
gaƕairbs	fügsam, getreu
gaƕeilains	Verweilen, Ruhe
gaiainna	gaiainna
gaidw*	Mangel
gailjan	fröhlich machen
Gainnesaraiþ	Gainnesaraiþ
gairda	Gürtel
bi-gairdan	umgürten
uf-gairdan	umgürten
Gairgaisainus*	Gairgaisainus*
gairnei	Verlangen, Wunsch
gairnjan	begehren, verlangen nach; bedürfen
gairuni*	Leidenschaft
us-gaisjan	erschrecken
gaitein*	Böcklein
gaits	Ziege
Gaïus	Gaïus
gajuk	(Gespann) Paar
gajuka	Genosse
gajuko	(Zusammenjochung, Zusammenstellung) Gleichnis
gakunds	Überredung
gakunþs	gakunþs
gakusts	Probe
galaista	Nachfolger
Galateis	Galateis
Galatia*	Galatia*
galaubeins	gläubig
galaubeins	Glaube
galaufs*	wertvoll
galeika*	eines Leibes
galeiki*	Abbild
galeiks	ähnlich
galeiko	gleich
Galeilaia	Galeilaia
Galeilaius	Galeilaius
galga	Pfahl, Kreuz
galigri	Beilager
galiug	Lüge
galiugaapaustaulus	falscher Apostel
galiugabroþar	falscher Bruder
galiugaguþ	Götze
galiugapraufetus*	falscher Prophet
galiugaweitwoþs	falscher Zeuge
galiugaxristus	falscher Christus
†galubaim	wertvoll
gamaindūþs	Gemeinschaft
gamainei	Gemeinschaft
gamainja	Teilnehmer
gamains	gemein
gamainþs	Versammlung
gamaiþs*	verkrüppelt; verwundet
gamalteins	Auflösung
gaman	Teilnehmer; Genosse
†gamarko	†gamarko
gamarzeins	Ärgernis
gamaudeins	Erinnerung
gameleins	Schrift; Buchstabenschrift
gaminþi	Gedächtnis, Erinnerung
gamitons	Gedanke
gamunds	Andenken, Gedächtnis
ganauha	Genüge, genügendes Auskommen; Genügsamkeit
ganists	Rettung, Heil
ganiþjis	Verwandter
ganohs	genug, viel
gansjan	verursachen
gaqiss	übereinstimmend
gaqiss	Verabredung
gaqumþs	Zusammenkunft, Versammlung; Vereinigung
garaideins	Anordnung, Satzung, Regel
garaihtei	Gerechtigkeit, Gebot
garaihteins	Zurechtweisung
garaihtiþa	Gerechtigkeit
garaihts	gerecht
garaiþs*	angeordnet
garazna	Nachbar
garazno	Nachbarin
garda	(Hürde) Viehhof
gardawaldands	Hausherr
gards	Haus, Hauswesen, Familie
garedaba	anständig
garehsns	bestimmte Zeit
gariudei	Schamhaftigkeit
gariudi	Ehrbarkeit
gariuþs*	ehrbar
garūni	Beratung
garunjo	Flut
garuns	Markt; Straße
gasahts	Vorwurf
gasateins	Grundlegung
gasinþa*	Gefährte
gasinþja*	Gefährte
gaskadweins*	Bedeckung
gaskafts	Erschaffung
gaskaideins	Unterschied
gaskalki	Mitknecht
gaskohi	Sandalen, Schuhe
gaskohs	beschuht
gastigodei	Gastfreundschaft
gastigoþs*	gastfrei
gasts	Fremdling (Gast)
gataura	Riß
gataurþs*	Zerstörung
gatemiba	geziemend
gatils	passend; geschickt zu
gatilaba	zur rechten Zeit, passend
gatimreins	Erbauung
gatimrjo	Gebäude
gatwo	Gasse
gaþagki	Bedacht
gaþaurbs	enthaltsam
gaþlaihts	Trost
gaþrafsteins	Trost
gaþrask	Tenne, Ausdrusch
gauja	Umgegend
Gaulgauþa	Gaulgauþa
Gaumaurra	Gaumaurra
Gaumaurjam	Gaumaurjam
gaumjan	bemerken
gaunon	klagen; Totenklage anstimmen
[gaunoþus]	Klage
gaurei	Betrübnis
gauriþa	Betrübnis
gaurjan	einen kränken
gáurs	betrübt, traurig
gawairþeigs	friedfertig
gawairþi	Friede
gawaleins	Erwählung
gawamms	gemein d.i. unrein
[gawandeins]	Bekehrung
gawargeins	Verurteilung
gawaseins	Bekleidung
gawaurdi	Gespräch
gawaurki	Geschäft; Erwerb; Gewinn
gawaurstwa	Mitarbeiter
[gawaurts]	eingewurzelt
gawi	Gau
gawiljis*	einmütig
gawiss	Verbindung, Band (der Gelenke)
gawizneigs	voll Mitfreude
gazaufwlakio	Schatzhaus
gazds	Stachel
faihu-geigan	begehren
ga-geigan	gewinnen
us-geisnan	sich entsetzen, erstaunen
giba	Gabe, Geschenk
giban	geben
gibands	Geber
af-giban sik	sich wegbegeben
at-giban	hingeben, übergeben
fra-giban	vergeben, verleihn, schenken
us-giban	erstatten, bezahlen
gibla	Giebel
gild	Steuer
fra-gildan	vergelten
us-gildan	vergelten
gilstr	Steuer
gilstrameleins	Eintragung in die Steuerliste
gilþa	Sichel
du-ginnan	beginnen
gistradagis	morgen
bi-gitan	finden
giutan	gießen
ufar-giutan	übergießen d.i. übervoll gießen
glaggwaba	sorgsam
glaggwo	genau
glaggwuba	genau
glitmunjan	glänzen
godakunds	von guter, edler Abkunft
godei	Tugend
goleins	Gruß
goljan	grüßen
goþs	gut
graba	Graben
graban	graben
bi-graban	mit einem Graben umgeben
uf-graban	nachgraben, unterwühlen
us-graban	ausgraben
gramjan	erzürnen
in-gramjan	erbittern
gramsta	Holzsplitter
gras	Gras, Kraut
gredags	hungrig
gredon	hungern
gredus	Hunger
greipan	greifen
fair-greipan	ergreifen
und-greipan	ergreifen
gretan	weinen, klagen
grets	das Weinen
grindafraþjis*	kleinmütig
griþs*	Schritt
groba	Grube, Höhle
grunduwaddjus	Grundmauer
gudafaurhts	gottesfürchtig
gudalaus	gottlos
gudaskaunei	Gottesgestalt
gudblostreis	Gottesverehrer
gudhūs	Gotteshaus
Gudilub	Gudilub
gudisks	göttlich
gudja	Priester
gudjinassus	Priestertum
gudjinon	Priester sein, des Priesteramts pflegen
gulþ	Gold
gulþeins	golden
guma	Mann
gumakunds	männlichen Geschlechts
gumein	Männchen
gund	Krebsgeschwür
us-gutnan	verschüttet werden
Gutþiuda	Gotenvolk
guþ	Gott
haban	haben, besitzen
af-haban	sich einer Sache enthalten
ana-haban	besitzen
at-haban	sich nähern
dis-haban	ergreifen
ga-haban	ergreifen
uf-haban	aufheben
hafjan	heben
and-hafjan	erwidern, antworten
at-hafjan	herabnehmen
ufar-hafjan	sich überheben
us-hafjan	erheben, wegnehmen
ufar-hafnan	sich überheben
haftjan	sich heften, hängen an
ga-haftjan	sich heften, hängen an
ga-gáhaftjan	zusammenheften, verbinden
ga-haftnan	anhangen
hafts	behaftet mit
hāhan	hängen, in der Schwebe lassen
at-hahan	hinabhängen, hinablassen
us-hahan	sich erhängen
hāhan	hangen
Haibraius	Haibraius
haidus	Art u. Weise
haifstjan	streiten
haifsts	Streit
háihs	einäugig
Haileias*	Haileias*
Haileisaius	Haileisaius
hailjan	einen (Akk.) oder etwas (Akk.) heilen
ga-hailjan	herstellen
ga-hailnan	hergestellt werden
hails	heil, gesund
haimoþli	Grundbesitz
haims*	Stadt
hairaiseis	Parteien
hairda	Herde
hairdeis	Hirt
Hairmaugaineis	Hairmaugaineis
Hairodia*	Hairodia*
hairto	Herz
hairþra	Eingeweide, Herz
hairus	Schwert
haizam	Fakkeln
haitan	heißen, nennen
ana-haitan	anrufen
and-haitan	einen, etw. bekennen; sich bekennen zu; etw. bekennen
at-haitan	herzurufen
fair-haitan	verheißen
ga-haitan	zusammenrufen
faura-gahaitan	zuvor verheißen
us-haitan	herausfordern
haiti	Geheiß
haiþi	Heide, Steppe
haiþiwisks	wild
háiþno	Heidin
hakuls	Mantel
halba	Hälfte, Seite
halbs	halb
haldan	hüten, weiden
haldis	mehr
halisaiw	kaum je, kaum
halja	Hölle
halks	leer, umsonst; dürftig, armselig
hallus	Fels
hals	Hals
[halsagga]	Hals, Nacken
halts	lahm
hamfs	verstümmelt
af-hamon	die Bekleidung ablegen, ausziehn
ana-hamon	die Bekleidung anlegen, anziehn
and-hamon	sich einer Sache entkleiden
ga-hamon	sich bekleiden mit
ufar-hamon	überziehn, sich mit etwas überkleiden
hana	Hahn
handugei	Weisheit
handugs	weise, klug
handus	Hand
handuwaurhts	mit der Hand gemacht
hansa	Schar; Manipel; Kohorte
ga-hardjan	verhärten
harduhairtei	Hartherzigkeit
hardus	hart, streng
harjis	Heer
hatan	hassen
hatis	Haß, Zorn
hatizon	zürnen
hatjan	hassen
haubiþ	Haupt
hauhei	Höhe
hauheins	Preis, Ehre
hauhhairtei	Hochmut
hauhhairts	hochmütig
hauhisti*	höchste Höhe
hauhiþa	Höhe
hauhjan	hoch machen; preisen
ufar-hauhjan	verblenden
us-hauhjan	erhöhn
us-hauhnan	verherrlicht werden
háuhs	hoch
hauhista	der Höchste (d.i. Gott)
hauhaba	hauhaba
hauhis	höher
hauhþuhts	hochmütig, verblendet
hauneins	Erniedrigung; Demut
hauniþa	Demut
haunjan	niedrig machen
ga-haunjan	erniedrigen
hauns	niedrig, demütig
haurds	(geflochtene) Tür
hauri	Kohle
haurn	das hornförmig gebogene Johannisbrot
haurnja	Hornist
haurnjan	das Horn blasen
hauseins	Gehör d.i. Ohr
hausjan	hören
and-hausjan	gehorchen
ga-hausjan	das Gehör bekommen
uf-hausjan	gehorchen
hausjon	hören
hawi	Heu
hazeins	Lob, Loblied
hazjan	loben, preisen wegen
heito	Fieber
heiwafrauja	Hausherr
helei	helei
Helei*	Helei*
Helias	Helias
Her	Her
her	hier, her
Herodes	Herodes
Herodia	Herodia
Herodianus*	Herodianus*
heþjo	Kammer
hi-	dieser
hidre	hierher
hilms	Helm
hilpan	einem helfen
ga-hilpan	helfen
himinakunds	von himmlischer Abkunft
himins	Himmel
himma, hina	dieser
hindana	hinter, jenseits
hindar	hinter, jenseits
hindarweis	hinterlistig
hindarweisei	Hinterlist
hindumists	der hinterste
fra-hinþan	gefangen nehmen
miþ-frahinþan	mitgefangen nehmen
us-hinþan	erbeuten
hiri	komm her, hierher
hita	dieser
hiufan	wehklagen, Klagelieder singen
hiuhma	Haufe, Menge
hiwi	Gestalt, Aussehn
hlahjan	lachen
bi-hlahjan	verlachen
hlaifs	Brot; Brotbissen
hlaine	Hügel
hlaiw	Grab
hlaiwasnos	Gräber
hlamma	Schlinge
hlas*	heiter
hlasoza	sorgenfreier
hlasei	Heiterkeit
af-hlaþan	beladen
us-hlaupan	aufspringen, sich aufmachen
hlauts	Los; Anteil, Erbschaft
hleibjan	sich annehmen
hleiduma	link
hleiþra	Zelt, Hütte
ufar-hleiþrjan	ein Zelt über mir aufschlage
hleþrastakeins	das Zeltaufschlagen, Laubhüttenfest
hlifan	stehlen
hliftus	Dieb
hlijans	Hütten, Zelte
hliuma	Gehör
uf-hlohjan	auflachen machen
hlutrei	Lauterkeit
hlutriþa	Lauterkeit
hlūtrs*	lauter, rein
hnaiweins	Erniedrigung, Demut
hnaiwjan	niedrig machen
ana-hnaiwjan	niederlegen
ga-hnaiwjan	erniedrigen
uf-hnaiwjan	einen unterwerfen unter (Dat.)
hnaiws	niedrig, demütig
hnasqjaim*	weich, weichlich
hneiwan	sich neigen
ana-hneiwan	sich niederbeugen
[ga-hnipnan]	sich betrüben
dis-hniupan	zerreißen
dis-hnupnan	zerreißen
hnuþo	spitzer Pfahl
hoha	Pflug
holon	durch Betrug schädigen, schikanieren
af-holon	übervorteilen
horinassus	Ehebruch; Hurerei
horinon	huren, Ehebruch treiben
ga-horinon	Ehebruch begehn
hors	Hurer, Ehebrecher
hrainei	Reinheit, wohl auch Reinigung
hraineins	Reinigung
hrainjahairts	reinen Herzens
hrainjan	reinigen
af-hrainjan	etwas Verunreinigendes tilgen
ga-hrainjan	reinigen
us-hrainjan	ausfegen
hrains	rein, ehrbar
hraiwadūbo	Turteltaube
hramjan	kreuzigen
us-hramjan	kreuzigen
af-hrisjan	abschütteln
us-hrisjan	abschütteln
hropjan	rufen
uf-hropjan	aufschreien, ausrufen
hrops	Ruf, Geschrei
hrot	Dach, Haus
hroþeigs	siegreich
hrugga	Stab
hrūkjan	krähen
hruk	das Krähen
and-hruskan	nachforschen
huggrjan	hungern
hugjan	denken, meinen
af-hugjan	bezaubern
†and-hugjan	†and-hugjan
faura-gahugjan	sich vornehmen
ufar-hugjan	sich überheben
hugs*	Verstand
hugs*	Landgut, Feld
huhjan	häufen, sammeln
huhrus	Hunger, Hungersnot
hulistr	Hülle
huljan	hüllen, verhüllen
and-huljan	enthüllen
dis-huljan	verhüllen
ga-huljan	verhüllen
us-hulon	aushöhlen
hulþs	hold
hulundi	Höhle
-hun	-hun
hunda	Hunderte
hundafaþs	Centurio
hunds	Hund
hunsl	Opfer
hunslastaþs	Opferstätte, Altar
hunsljan	opfern
hunþs*	Fang, Beute
hups	Hüfte
huzd	Hort, Schatz
huzdjan	Schätze sammeln
Hwmainaius	Hwmainaius
hwssopon	hwssopon
ƕad	wohin
ƕadre	wohin
ƕa-h	jeder
ƕairban	wandeln
bi-ƕairban	umdrängen
ƕairnei*	Schädel
ƕaiteis*	Weizen
ƕaiwa	wie
ƕan	wann
ƕanhun	jemals
af-ƕapjan	ersticken, auslöschen
af-ƕapnan	ersticken, erlöschen
ƕar	wo
ƕarbon	wandeln
ƕarjis	wer
ƕarjizuh	jeder
ƕas	wer?
ƕashun	jemand
ƕassaba	scharf, streng
ƕassei	Schärfe, Strenge
[gaƕatjan]	[gaƕatjan]
ƕaþ	wohin
ƕaþar	wer von beiden
[ƕaþaruh]	jeder von beiden
ƕaþjan	schäumen
ƕaþo	Schaum
ƕaþro	woher
ƕazuh	jeder
ƕe	wem, mit wem, womit
ƕeh	jedenfalls, nur
ƕeila	Weile, Zeit, Stunde
ƕeilaƕairbs	nur eine Zeitlang dauernd, vergänglich
ƕeilan	aufhören
ana-ƕeilan	beruhigen, erquicken
ga-ƕeilan	zur Ruhe kommen, aufhören
ƕeilohun	nicht eine Stunde lang
ga-ƕeitjan	weißen
ƕeits	weiß
ƕelauþs*	wie groß
ƕileiks	wie beschaffen?
ƕilftrjom	Totenkiste, Sarg
ƕoftuli	Das Rühmen, der Ruhm
ƕoh	jeder
ƕopan	sich einer Sache rühmen
ƕota	Drohung
ƕotjan	drohen
ga-ƕotjan	einen bedrohn
Iaeirus	Iaeirus
Iairaimias*	Iairaimias*
Iairaupaulein	P064.10
Iaireiko*, Iairiko*	Iericho
Iairusalem	Iairusalem
Iairusaulwma	Iairusaulwma
Iairusaulwmeis	Iairusaulwmeis
Iairusaulwmeite	Iairusaulwmeite
Iaissaizis	Iaissaizis
Iakob	Iakob
Iakobus	Iakobus
Iaredis	Iaredis
Iareim	Iareim
Iasson	Iasson
Iaurdanus*	Iaurdanus*
ibai	doch nicht?
ibdaljin	Berglehne
ibna	gleich
ibnaleiks	gleichen Körpers
ibnaskauns*	gleichschön
~skauneis*	~skauneis*
ibnassus	Gleichheit
ga-ïbnjan	gleich machen
ibns	eben, flach
ibuks	rückwärts gewandt
iddja	iddja
idreiga	Buße
idreigon	Reue empfinden
ga-ïdreigon	bereuen, Buße tun
Idumaia	Idumaia
idweit	Schmach, Schimpf
idweitjan	schmähn
Iesus	Iesus
iftuma	am folgenden Tage
iggqar	euch beiden gehörig
igqis	igqis
ik	ich
ikei	der ich
in	in, auf, an, unter
inahei	Besonnenheit, Selbstbeherrschung
inahs	verständig
ingardja	Hausgenosse
inilo	Entschuldigung
inkilþo	schwanger
inkunja*	Stammesgenosse, Landsmann
inmaideins	Vertauschung
inn	hinein
inna	innen, innerhalb
innakunds	zum Hause gehörig, Hausgenosse
innana	von innen
innatgāhts*	Eingang, Eintritt
innaþro	von innen
inniujiþa	Erneuerung
innuma	der innere
insahts	Erzählung, Aussage, Zeugnis
inuh	ohne, außer
in-uh, in-uþ-	in, auf, an, unter
inwindiþa	Ungerechtigkeit
inwinds	ungerecht
[inwitoþs]	innerhalb des Gesetzes stehend
Ioanan	Ioanan
Ioda	Ioda
Iohanna	Iohanna
Iohanna	Iohanna
Iohannes	Iohannes
Iora	Iora
Ioreim	Ioreim
Iosef	Iosef
Iosezis	Iosezis
is M, si F, ita N	er, der
Isak	Isak
Iskariotes	Iskariotes
Israel	Israel
Israeleites	Israeleites
itan	essen
fra-ïtan	etw. verzehren, fressen
Ituraia	Ituraia
iþ	aber
Iudaia	Iudaia
Iudaialand	Iudaialand
Iudaius	Iudaius
Judaius	Judaius
iudaiwisko	auf jüdische Weise
iudaiwiskon	jüdisch leben
Iudas	Iudas
iumjo	Haufe
iup	aufwärts
iupa	oben
iupana	von oben
iupaþro	von oben her
Iuse	Iuse
iusila	Erholung
iusiza	vorzüglicher
izei	izei
ize	ize
izwar	euer
izwizei	der du
ja	ja
jabai	ob
Jaeirus	Jaeirus
jah	und, und zwar, auch
jai	ja, wahrlich, fürwahr
jainar	an jenem Ort, dort
jaind	dorthin
jaindre	dorthin
jaindwairþs	dorthin gewandt
jains	jener
jainþro	dorther
Jairupulai	P072.07
Janna	Janna
Jannes	Jannes
jaþþe	und wenn
jau	ob
Jaurdanau	Jaurdanau
jer	Jahr
jiuka	Zornausbrüche; Streitereien
jiukan	kämpfen; obsiegen
ga-jiukan	besiegen
Jiuleis	Julmonat
jota	jota
ju	schon
judaiwisks	jüdisch
Judaius	Judaius
Judas	Judas
juggs	jung; jugendlich
juk	Gespann
jukuzi*	Joch
junda	Jugend
jūs	ihr
Justus	Justus
juþan	schon
jūzei	jūzei
Kaballarja	Kaballarja
Kaeinan	Kaeinan
Kafarnaum	Kafarnaum
Kaidmeiel	Kaidmeiel
Kaidron	Kaidron
kaisar*	Kaiser
kaisaragild	Census, Steuer
Kaisaria	Kaisaria
Kajafa	Kajafa
kalbo	Kalbe (weibliches Kalb von mehr als einem Jahr, das noch nicht gekalbt hat)
kalds	kalt
kalkinassus	Hurerei
kalkjom	Hure
Kananeites*	Kananeites*
kann	kennen, wissen
kannjan	einem (D.) etw. (A.) kund tun
ga-kannjan	verkünden
us-kannjan	verkünden
kapillon	das Haar abschneiden
kara	Sorge
[Kareiaþiareim]	[Kareiaþiareim]
karkara	Kerker
karon	sich kümmern
ga-karon	besorgen
Karpus	Karpus
kas	Gefäß
kasja	Töpfer
katile	Kessel
Kaulaussaium	den Kolossern
kaupatjan	ohrfeigen
kaupon	Geschäfte machen, Handel treiben
Kaurazein	Kaurazein
kaurban	Gabe, fromme Stiftung
[kaurbaunan]	Tempelschatz
kaurei*	Schwere, Fülle
Kaurinþius	Kaurinþius
Kaurinþon	Kaurinþon
kauriþa	Last
kaurjan	drücken, belästigen
ana-kaurjan	beschweren
miþ-kaurjan	mitbelastet mit
kaurjos	schwer, lästig
kaurn	Getreide
kaurno	Korn
kausjan	kosten, kennen lernen
ga-kausjan	erproben
kawtsjo	kawtsjo
Kefas	Kefas
keinan	keimen
us-keinan	hervorkeimen
miþ-uskeinan	mithervorkeimen
kelikn	Turm; Speisesaal im Obergeschoss
Kileikia*	Kileikia*
kilþei	Mutterleib
kindins	Statthalter
kinnus	Wange
kintus	Heller
kiusan	etwas (A.) prüfen
ga-kiusan	erproben
us-kiusan	erproben
Klemaintau	Klemaintau
Klaimaintau	Klaimaintau
klismjan	gellen
klismo	Becken
kniu*	Knie
knodai	Geschlecht
knussjan	niederfallen
Kosam	Kosam
Kreks	Grieche (Heide)
[Kreskus]	[Kreskus]
Kretai	Kretai
Kretes	Kretes
Krispus	Krispus
kriustan	knirschen
ga-kroton	zerbrechen, zerschellen
krusts	Knirschen
kubitus	Tischgesellschaft, Gruppe
kukjan	einen küssen
bi-kukjan	mit Küssen bedecken
ana-kumbjan	sich niederlegen, zu Tische legen
kumei	kumei
kunawida*	Fessel
kuni	Geschlecht, Stamm
kunnan	kennen, wissen
fra-kunnan	verachten
ga-kunnan	sich unterordnen, gehorchen
-kunnan	-kunnan
ana-kunnan	etw. lesen
at-kunnan	gewähren
ga-kunnan	kennen lernen, erfahren
uf-kunnan	erkennen
kunþi	Kunde, Kenntnis
kunþs	kund, bekannt
Kusa	Kusa
Kustanteinus	Kustanteinus
kustus	Prüfung
Kwreinaius	Quirinius
Kwreinaius	Einwohner von Kyrene
laggamodei	Langmut
laggei	Länge
laggs	lang
lagjan	legen, auflegen, hinlegen
af-lagjan	etwas ablegen
ana-lagjan	einem (D.)  etw. (A.) auflegen
at-lagjan	hinlegen, auflegen
faur-lagjan	einem (D.) etw. vorlegen
ga-lagjan	hinlegen
ufar-lagjan	überdecken
us-lagjan	us-lagjan
laian*	schmähn
lauan*	lauan*
laiba	Überbleibsel
bi-laibjan	übrig lassen
bilaif	bleiben
laigaion	Legion
bi-laigon	etw. belecken
laikan	hüpfen, springen
bi-laikan	einen (A.) verspotten
laiks	Tanz
laiktjo	Leseabschnitt
lais	(ich) weiß
laisareis	Lehrer
laiseigs	zum Lehren befähigt
laiseins	Lehre
laisjan	lehren
ga-laisjan	lehren
us-laisjan	belehren
laistjan	einem folgen, nachstreben
afar-laistjan	einem nachfolgen, nachstreben; nachgehn (beobachtend verfolgen)
ga-laistjan	Gastfreundschaft pflegend
laists	Spur
Laiwweis	Laiwweis
Laiwweiteis	Laiwweiteis
Lamaik	Lamaik
lamb	Lamm, Schaf
land	Land; Gegend
lasiws	schwach
latei	Lässigkeit
latjan	aufhalten
ana-latjan	verhindern; ihr bekommt keine Gelegenheit
ga-latjan	verhindern
lats	lässig, faul
laþaleiko	gern
laþon	(ein)laden
at-laþon	berufen
ga-laþon	zusammenberufen, einladen
laþons	Einladung, Berufung
lauan*	schmähn
ga-laubjan	glauben
us-laubjan	einem erlauben
Laudeikaia*	Laudeikaia*
laudi	Gestalt
laufs	Laub, Blatt
laugnjan	leugnen
ga-laugnjan	verborgen bleiben
lauhatjan	blitzen
lauhmuni*	Blitz
Lauidjai	Lauidjai
laun	Lohn
launawargs*	undankbar
laus	los, leer
lausawaurdei	leeres Gerede
lausawaurdi	leeres Gerede
lausawaurds	hohle Schwätzer
laushandja	mit leeren Händen
lausjan	lösen
ga-lausjan	erlösen, befreien
us-lausjan	entwurzele dich
lausqiþrei	Fasten
lausqiþrs*	leeren Magens, nüchtern
Lazarus	Lazarus
bi-leiban*	bleiben
leihts	leicht
leiƕan	leihen; sich borgen von
leik	Körper, Leib
leikains	Gefallen
leikan	einem gefallen, zu Gefallen sein
ga-leikan	gefallen
faura-galeikan	vorhergefallen
leikeins	leiblich, fleischlich
leikeis, leikinassus, leikinon	Arzt
silda-leikjan, silda-leiknan	anstaunen, bewundern
gáleikon	meine Nachahmer
ga-gáleikon	sich verwandeln, eine Gestalt annehmen
in-gáleikon	verwandeln
miþ-gáleikon	mitnachahmen
þairh-gáleikon	þairh-gáleikon
lein	Leinwand
leitan	lassen
leitils	klein, wenig
af-leiþan	weggehn, entweichen, verreisen
bi-leiþan	verlassen, zurücklassen
ga-leiþan	kommen, gehn
inn-galeiþan	hineingehn
miþ-inngaleiþan	mithineingehn
hindar-leiþan	hinzukommen
þairh-leiþan	hindurchgehn
ufar-leiþan	übersetzen
us-leiþan	hinausgehn, weggehn; verreisen
leiþu	Obstwein
lekeis	Arzt
lekinassus*	Heilung
lekinon	heilen
ga-leikinon	herstellen
letan	lassen
af-letan	entlassen
fra-letan	lassen; frei lassen, entlassen; unterlassen; zulassen, erlauben; erlassen, vergeben; herablassen
us-letan	ausschließen
and-letnan	scheiden
lew	Gelegenheit, Veranlassung
lewjan	verraten
fra-lewjan	verraten
ga-lewjan	hingeben, überlassen
libains	Leben
liban	leben
miþ-liban	mitleben
af-lifnan	übrig bleiben
ligan	liegen
at-ligan	steht in meiner Macht
uf-ligan	unterliegen
ligrs	Lager, Bett
lima	lima
af-linnan	weggehn
lisan	lesen, sammeln
ga-lisan	zusammenlesen, versammeln
listeigs	listig
lists	List
litai	Heuchelei
liteins	Bittgebet
miþ-litjan	heucheln mit
liþus	Glied
liubaleiks	lieblich
liudan	wachsen
awi-liudon	einem (Dat.) danken
liufs*	lieb
liuga	Heirat, Ehe
liugan	heiraten
ga-liugan	ein Weib nehmen
liugan	lügen
liugn	Lüge
liugnapraufetus*	Lügenprophet
liugnawaurds	Lügen redend
liugnja	Lügner
liuhadei*	liuhadei*
liuhadeins	Helle, Glanz
liuhadeins*	hell
liuhaþ	Licht
liuhtjan	leuchten
ga-liuhtjan	etw. erleuchten, ans Licht bringen
in-liuhtjan	erleuchten
fra-liusan	etwas verlieren
liutei	Heuchelei
liuts	Gaukler
liuþareis	Sänger
liuþon	einem lobsingen
lofa*	flache Hand
Loþ*	Loþ*
lubains	Hoffnung
lubjaleis	giftkundig
lubjaleisei	Giftmischerei, Zauberei
ludja*	Angesicht
luftu	Luft
ga-lūkan	verschließen
us-lukan	erschließen, öffnen
lukarn	Leuchte, Licht
lukarnastaþa	Leuchter
Lukas	Lukas
Lukius	Lukius
ga-luknan	sich verschließen
us-luknan	sich erschließen, öffnen
lun	Lösegeld
fra-lusnan	verloren gehn
luston	begehren
lustus	Lust, Begierde
lustusama	ersehnt
luton	taüschen
us-luton	verführen, irre führen
Lwddomaeis	Lwddomaeis
Lwsanius*	Lwsanius*
Lwstrws	Lwstrws
Maeinan*	Maeinan*
magan*	können, vermögen
ga-magan*	gelten, bedeuten
magaþei	Jungfrauschaft
magaþs*	Jungfrau
Magdalan	Magdalan
Magdalene	Magdalene
magula	Knäblein
magus	Knabe
Mahaþ*	Mahath
mahteigs	mächtig; möglich
ana-mahtjan	vergewaltigen; rauben; kränken, quälen; erpressen; mißhandeln
mahts	mahts
mahts	Macht, Kraft, Vermögen
maidjan	tauschen
in-maidjan	verwandeln
maihstus	Mist
Mailaian*	Mailaian*
maile	Runzel
Mailkei*	Mailkei*
maimbrana	Pergament
gámainjan	gemein machen
ga-gámainjan	verunreinigen
mais	mehr
Maisaullam*	Maisaullam*
maists	der größte
maist	höchstens
maitan	etw. schneiden, hauen von
af-maitan	abhauen, abschneiden
bi-maitan	beschneiden
ga-maitan	zerschneiden, verschneiden
us-maitan	ausschneiden, abschneiden, ausrotten
maiþms	Geschenk
maiza	größer
Makeibis	Makeibis
Makidoneis	Makidoneis
Makidonja	Makidonja
Makmas	Makmas
malan	mahlen
[Malailaiel]	[Malailaiel]
Malkus	Malkus
malma	Sand
malo	Motte
ga-malwjan	zermalmen
Mambres	Mambres
mammo	Fleisch
mammona*	mammona*
bi-mampjan	verhöhnen
man	meinen, glauben, dafür halten
managdūþs	Fülle
managei	Menge
managfalþs	mannigfaltig
managjan	etw. mehren
managnan	reichlich vorhanden sein, Überfluß haben an
us-managnan	sich vermehren zu
manags	mancher, viel
manamaurþrja	Menschenmörder
manaseþs	Welt, Menschheit
manaulja	der Gestalt nach
manleika	Bild
manna	manna
manna	Mensch, mann
mannahun	niemand
manniskodus	Menschlichkeit
mannisks	menschlich
manwiþa	Bereitschaft
manwjan	etw. bereitmachen, zurechtmachen
faura-manwjan	etw. vorbereiten
ga-manwjan	einem etw. (zu)bereiten zu
faura-gamanwjan	etw. vorher zubereiten
manwus	bereit
maran aþa	der Herr kommt
marei	Meer
Maria	Maria
marikreitum	Perle
marisaiws*	See
Marja	Marja
marka	Mark, Grenze
[Markaillaus]	Marcellus von Ancyra
[ga-markon]	[ga-markon]
Markus	Markus
†marwtre	Martyrer
Marþa	Marþa
marzeins	Ärgernis
marzjan	einen ärgern, ihm zum Ärgernis sein
af-marzjan	Ärgernis nehmen
ga-marzjan	Ärgernis erregen
matibalgs	Ranzen, Speisesack
matjan	essen
ga-matjan	essen
mats	Speise
Mattaþanis	Mattaþanis
Mattaþius*	Mattaþius*
Matþaius*	Matþaius*
Matþat	Matþat
maþa	Wurm
maþl*	Versammlungsort, Marktplatz
maþlein	Rede, Redeweise
maþljan	reden
Maþusalis	Maþusalis
maudjan	einen erinnern
ga-maudjan	einen erinnern an
maurgins	Morgen
ga-maurgjan	verkürzen
maurnan	sorgen für (Dat.)
maurþr	Mord
maurþrjan	morden
mawi	Mädchen
mawilo	Mädchen
megs	Eidam
meins	mein
meki	Schwert
mel	Zeit, Stunde
mela	Scheffel
meljan	schreiben
ana-meljan	aufschreiben
faura-meljan	vorzeichnen, vormalen
ga-meljan	schreiben
faura-gameljan	vorher schreiben
uf-meljan	unterschreiben
ufar-meljan	etw. überschreiben
mena	Mond
menoþs	Monat
mereins	Verkündigung, Predigt
Merila	Merila
meriþa	Gerücht, Kunde
merjan	etw. künden, kund tun
merjands	Verkündiger, Prediger
us-merjan	verkünden
wailamerjan	einem eine frohe Botschaft künden
wajamerjan	lästern
us-mernan	sich (durchs Gerücht) verbreiten
mes	Tisch; Schüssel, Platte; Kelter
midgardiwaddjus	Zwischenwand
midjasweipains	Überflutung, Sintflut
midjis*	midjis*
midjungards	die bewohnte Erde, der Erdkreis
miduma*	Mitte
midumonds	Mittler
mikildūþs	Größe
mikilei	Größe
mikiljan	preisen
ga-mikiljan	preisen
mikilnan	verherrlicht werden
mikils	groß
mikilþuhts	hochmütig
mildiþa	Milde
milhma	Wolke
militon	die Soldaten
miliþ	Honig
miluks*	Milch
mimz	mimz
minnists	der kleinste, geringste
minniza	kleiner, geringer
mins	minder, weniger
minznan	abnehmen
missadeþs*	Missetat
missaleiks	verschieden
missaqiss	Zwiespalt, Mißrede
missataujands	Übeltäter
misso	einander
mitadjo	Maß
mitan	messen
ga-mitan	zumessen
us-mitan	wandeln, sich benehmen, leben
mitaþs	Maß
miton	ermessen, (be)denken, überlegen
ufar-miton	vergessen
mitons	Überlegung, Gedanke
miþ	mit, bei, unter
miþgardawaddjus	Zwischenwand
miþþan	inzwischen
miþþanei	während
miþwissei	Bewußtsein, Gewissen
mizdo	Lohn
modags	zornig auf (Dat.)
af-mojan*	ermüdet
Moses	Moses
mota	Zoll
ga-motan*	Raum finden
motareis	Zöllner
motastaþs	Zollstätte
ga-motjan	einem begegnen
wiþra-gamotjan	einem begegnen
moþs*	Zorn
mukamodei*	Nachgiebigkeit, Sanftmut
mulda	Staub
muldeins	von Staub, irdisch
faur-mūljan	einem das Maul verbinden
munan	meinen, glauben, dafür halten
ga-munan	sich einer Sache
munan	etw. zu tun gedenken, wollen
mundon	einen besehn, sehen auf
mundrei*	Ziel
ufar-munnon	vergessen
muns	Gedanke, Meinung
munþs	Mund
Nabaw*	Nabaw*
nadre	Natter
[Naem]	[Naem]
Naggai*	Naggai*
ga-nagljan	festnageln an
bi-nah	es ist erlaubt, nötig
ga-nah	es genügt einem
Nahasson	Nahasson
nahtamats	(Hauptmahlzeit), Abendessen, Abendmahl, Gastmahl
nahts	Nacht
Naiman	Naiman
naiteins	Lästerung
ga-naitjan	beschimpfen
Naitofaþeis	Naitofaþeis
Nakor	Nakor
namnjan	nennen
ga-namnjan	benennen
namo	Name
ana-nanþjan	Mut fassen, sich erkühnen
†ga-nanþjan	aufhören
naqadei	Nacktheit
naqaþs	nackt
nardus	Narde
naseins	Rettung, Heil
nasjan	retten
nasjands	Heiland
ga-nasjan	erretten, herstellen
nati	Netz
natjan	netzen
ga-natjan	benetzen
Naþan	Naþan
Naubaimbair	November
naudibandi	Kette, Handschellen
naudiþaurfts	notwendig
naudiþaurfts	Notwendigkeit
Nauel	Nauel
nauh	noch
nauhþan	noch
nauhþanuh	noch
nauhuþþan	und sogar noch
Naum	Naum
naus	der Tote
nauþjan	nötigen
ana-nauþjan	durch Zwang veranlassen
nauþs	Not, Zwang
nawis	tot
ga-nawistron	begraben
miþ-ganawistron	einen mit jemand (Dat., vgl. 256,2) begraben
Nazaraiþ	Nazaraiþ
Nazoraius	Nazoräer, Nazarener
Nazorenus*	Nazoräer, Nazarener
ne	nein
neƕ	nahe
neƕis	näher
neƕa	nahe
neƕjan	sich einem nähern
at-neƕjan	herannahen
neƕundja	der Nächste
nei	nicht
neiþ	Neid
Ne(i)kaudemus	Ne(i)kaudemus
neiwan*	es auf jemand abgesehn haben
Nerins	Nerins
neþla	Nadel
ni	nicht
nibai, niba	doch nicht etwa?
nidwa	das Verzehren, der Rost
nih	und nicht, auch nicht, nicht
Nikaudemus	Nikaudemus
niman	nehmen, annehmen, aufnehmen, empfangen, fangen
af-niman	abnehmen, wegnehmen
and-niman	annehmen, aufnehmen, empfangen
at-niman	aufnehmen; wohin versetzen
bi-niman	wegnehmen
dis-niman	besitzen
fra-niman	nehmen
ga-niman	mitnehmen
in-niman	hernehmen
miþ-niman	annehmen, gelten lassen
us-niman	herausnehmen, wegnehmen
ga-nisan	genesen, errettet werden
nist	nist
niþan	helfen
niþjis	Verwandter
niþjo	die Verwandte
niu	nicht
niuhseins	Heimsuchung
bi-niuhsjan	auskundschaften, ausspionieren
ana-niujan	erneuern
niujasatiþs*	(eig. neugepflanzt) der Neubekehrte, der Neuling
niujis	neu
niujiþa	Neuheit
niuklahei	Unverstand
niuklahs	unmündig, kindisch
niun	neun
niunda	der neunte
niuntehund	neunzig
niutan	treffen, erreichen; einer Sache froh sein
ga-niutan	ergreifen, erwischen
ga-nohjan	die er uns reichlich gewährte
ga-nohnan	zur Genüge versehn sein mit (Dat.)
notin	auf dem Achterdeck
nu	nun, jetzt
nuh	denn
nunu	demnach, daher
nuta	Fänger, Fischer
Nwmfan	Nwmfan
o	ach, pfui
Obeid*	Obeid*
Odueia*	Odueia*
ogan*	sich fürchten vor (Akk.)
ogjan	einen schrecken
ohteigo	Zeit habend
Osaiin	Osaiin
osanna	osanna
paida	Leibrock, Unterkleid
ga-paidon	(mit einem Leibrock) bekleiden
paintekuste*	paintekuste*
Paitrus	Paitrus
papan	Presbyter, Geistlicher
parakletus	Tröster
paraskaiwe	Rüsttag
paska	paska
pasxa	pasxa
Pauntius*	Pauntius*
paurpura	Purpur
paurpaura	paurpaura
paurpuroþs	purpurn
Pawlus	Pawlus
peikabagms	Palmbaum
Peilatus	Peilatus
[pistikeins]	unverfälschte o. flüssige Narde
plapja	Straße
plat	Flicken
plinsjan	tanzen
ana-praggan	bedrängen
praitoriaun	praitoriaun
praizbwtairei	christlich. Gemeindebehörde
praizbwtairi*	praizbwtairi*
praufeteis	Prophetin
praufetes	Prophet
praufetja	Weissagung
praufetjan	weissagen
Priska	Priska
psalmon	Psalm
pugg	Geldbeutel
pund	Pfund
qainon	weinen, trauern
qairrei	Sanftmut
qairrus	sanft, freundlich gegen
qairu	Pfahl, Stachel
Qartus	Quartus
qens	Eheweib
qiman	kommen
ana-qiman	hinzutreten
bi-qiman	einen überfallen
faura-qiman	vor jemand hergehn
fra-qiman	etw. verzehren, ausgeben, vertun
ga-qiman	zusammenkommen
miþ-qiman	mitkommen mit
us-qiman	umbringen, den Tod geben
qinakunds	weiblichen Geschlechts
qineins	Frauenzimmer, Weibsleute
qino	femina, Weib
qisteins	Verderben
qistjan	verderben
fra-qistjan	verderben, umbringen
us-qistjan	verderben, umbringen
fra-qistnan	umkommen, zugrunde gehn
qiþan	sagen
af-qiþan	verzichten auf
ana-qiþan	verleumden, verlästern
and-qiþan	Abschied nehmen (entlassen)
faur-qiþan	sich entschuldigen
faura-qiþan	vorhersagen
fra-qiþan	für ungültig erklären, aufheben
ga-qiþan	sich verabreden, übereinkommen, beschließen
miþ-qiþan	mitsprechen, nachsprechen
us-qiþan	ein Gerede verbreiten
qiþuhafto	die Schwangere
qiþus	Magen; Mutterschoß
ana-qiujan	beleben
ga-qiujan	beleben
miþ-gaqiujan	mitbeleben
ga-qiunan	aufleben
qius*	lebendig
†qrammiþa	Feuchtigkeit
qums	das Kommen; Gegenwart, Ankunft, Wiederkunft Christi
rabbaunei	rabbaunei
rabbei	rabbei
Ragaw*	Ragaw*
ragin	Rat, Beschluß
ragineis	Ratgeber, Ratsherr
raginon	etw. verwalten
ga-raginon	einen Rat geben
rahnjan	rechnen
faura-rahnjan	einen übertreffen an
ga-rahnjan	abschätzen
rahton	darreichen
Raibaikka	Raibaikka
raidjan	verordnen
ga-raidjan	befehlen, verordnen, bestimmen
raihtis	nämlich, doch, etwa
gáraihtjan	als gerecht erweisen
at-gáraihtjan	vollends in Ordnung bringen
raihts	recht, grade
raihtaba	recht, richtig
ur-raisjan	zum Aufstehn bringen, aufrichten, erwecken
raka	raka
uf-rakjan	aufrecken
Rama	Rama
ur-rannjan	aufgehn lassen
rasta	Meile
ga-raþjan	zählen
raþjo	Abrechnung, Konto; Zahl
raþizo	leichter
bi-raubon	einen berauben
in-rauhtjan	erzürnt werden
raupjan	raufen
raus	Rohr
rauþs*	rot
razda	Sprache, Sprechweise
razn	Haus
ga-redan	Vorsorge treffen für
faura-garedan	einen vorherbestimmen zu
und-redan	besorgen, gewähren
ur-redan	warum lasset ihr euch Satzungen auflegen, als lebtet ihr in der Welt
reiki	Reich, Herrschaft, Obrigkeit
reikinon	herrschen über
reikeis*	reikeis*
reiks*	reiks*
reiks	Herrscher, Obrigkeit
reiran	zittern
in-reiran	erzittern, erbeben
reiro	das Zittern
ur-reisan	erstehn, sich erheben
Resa*	Resa*
rign	Regen
rignjan	regnen
rikan	häufen
rimis*	Ruhe
rinnan	rennen, laufen
and-rinnan	streiten
at-rinnan	hinzulaufen
du-atrinnan	hinzulaufen
bi-rinnan	einen umringen
du-rinnan	hinzulaufen
fair-rinnan	sich erstrecken, reichen zu
faur-rinnan	vorhergehn
fra-rinnan	sich verlaufen zu, geraten unter
ga-rinnan	zusammenlaufen, zusammenkommen
und-rinnan	zufallen, zuteil werden
ur-rinnan	auslaufen, ausgehn
rinno	Gießbach
riqis	Finsternis
riqizeins	finster
riqizjan	finster werden
riurei	Vernichtung, vom ewigen Tod gesagt
riurjan	verderben
riureis*	vergänglich, sterblich
riurs*	riurs*
rodjan	sprechen, reden
bi-rodjan	murrend reden, murren
miþ-rodjan	mit einem reden
rohsns	Hof
Rufus	Rufus
rūmis	Raum
Rūma*	Rūma*
ur-rūmnan	sich erweitern
Rūmoneis*	Rūmoneis*
rūms	geräumig
rūna	Geheimnis
runs	Lauf
sa	der, dieser
Sabaillius	Sabellius
saban*	feine Leinwand
Sabaoþ	Sabaoþ
sabbato	sabbato
Saddukaieis	Saddukaieis
sads	satt
saei	der
saggqjan	senken
uf-saggqjan	versenken
uf-saggqjan	uf-saggqjan
saggqa	Untergang, Westen
saggws	Vorlesung, Rezitation
sah	der u. kein andrer, eben der
saƕazuh	was auch immer
sai	ecce, sieh
saian	säen
in-saian	einsäen
saihs	sechs
saihsta	der sechste
saiƕan	sehn
and-saiƕan	auf etw. sehn, es berücksichtigen
at-saiƕan	auf etw. sehn, acht geben
bi-saiƕan	umsehn
ga-saiƕan	erblicken
in-saiƕan	hinsehn; auf etw. sehn, nach etw. sehn
þairh-saiƕan	dúrchschauen
us-saiƕan	aufblicken
in-sailjan	anseilen
Sailaum	Sailaum
Saimaiein	Saimaiein
sainjan	zögern, säumen
sáir	Schmerz
Sairok	Sairok
saiwala	Seele
saiws	See
Saixaineia	Saixaineia
sakan	streiten
and-sakan	widersprechen, bekämpfen
ga-sakan	schelten
in-sakan	vorstellen, anraten; eintreten für; bezeichnen
ana-insakan	ana-insakan
us-sakan	erörtern, vorlegen
sakjo	Streit
sakkus	Sack
sakuls	streitsüchtig
Salamis	Salamis
Salaþiel	Salaþiel
salbon	salben
ga-salbon	(be)salben
salbons	Salbe
saldra	leichtfertiges Geschwätz
saliþwos	Herberge
saljan	opfern
and-saljan	darbringen
ga-saljan	zum Opfer bringen
saljan	herbergen, bleiben
us-saljan	Herberge nehmen
Salmon	Salmon
Salome	Salome
salt	Salz
saltan	salzen
sama	derselbe, der nämliche
samafraþjis*	samafraþjis*
samakuns*	desselben Geschlechts, verwandt
samalauþs*	gleich groß
samaleiks	gleich
samaleiko	auf gleiche Weise, gleich-, ebenfalls
samana	zusammen, zugleich
samaqiss	Übereinstimmung
Samareites	Samareites
Samaria	Samaria
samasaiwals*	einmütig
samaþ	nach einem und demselben Ort hin; zusammen
samjan	die den Menschen zu gefallen suchen
sandjan	senden
ga-sandjan	entsenden, geleiten
faura-gasandjan	vorausentsenden
in-sandjan	entsenden
miþ-insandjan	mitentsenden
ga-miþsandjan	mitentsenden
us-sandjan	aussenden
Saraipta	Saraipta
Sarra	Sarra
sarwa	Waffen
Satana	Satan
satjan	setzen
af-satjan	absetzen, entlassen
at-satjan	darstellen
bi-satjan	umgeben
ga-satjan	hinsetzen, hinstellen, hinlegen
faura-gasatjan	vorstellen, darstellen
miþ-satjan	versetzen
us-satjan	setzten darauf
saþs*	satt
Saudauma	Saudauma
sauhts*	Krankheit
sauïl	Sonne
Saulaumon	Saulaumon
bi-sauljan	besudeln
bi-saulnan	besudelt werden
sauls	Säule
Saur	Syrer
Saurais	Saurais
saurga	Sorge, Kummer
saurgan	sorgen, bekümmert sein
Saurini	Syrerin
sauþa	Grund
sauþs	Opfer
sei	sei
Seidona*	Seidona*
Seidoneis*	Seidoneis*
Seimon	Seimon
Seina	Seina
sik	sich
seinaigairnai	selbstsüchtig
*seins	sein, ihr
seiteins	täglich
seiþus	spät
selei	Tüchtigkeit, Güte
sels	gut, gütig
Sem	Sem
Seþ*	Seþ*
sibakþanei	sibakþanei
sibja	Sippenverhältnis, Verwandtschaft
ga-sibjon	sich mit einem (Dat.) versöhnen
sibun	sieben
sibuntehund	siebzig
sidon	üben
sidus	Sitte, Gewohnheit
sifan	sich freuen, frohlocken
siggwan	singen; vorlesen, rezitieren
us-siggwan	vorlesen, rezitieren
sigis	Sieg
sigislaun	Siegeslohn
sigljan	einen mit einem Siegel versehn, ihn siegeln
faur-sigljan	versiegeln
ga-sigljan	besiegeln, bestätigen
sigljo	Siegel
sigqan	sinken
dis-sig(g)qan	untersinken
ga-siggqan	versinken, untergehn
†sihw	†sihw
sikls*	Sekel
ana-silan	verstummen
silba	selbst
Silbanus	Silvanus
silbasiuneis*	Augenzeuge
silbawiljis*	freiwillig
sildaleik	Staunen, Verwunderung
sildaleikjan	anstaunen, bewundern
sildaleiknan	bewundert werden
sildaleiks	erstaunlich, wunderbar
Siloam	Siloam
silubr	Silber
silubreins	silbern
simle	einst, vordem
sinapis	Senf
sineigs	sineigs
sinista	der Älteste
sinteins	täglich
sinteino	immer, allezeit
sinþs*	Gang
Sion	Sion
siponeis	Schüler, Jünger
siponjan	jemandes Schüler sein
sitan	sitzen
and-sitan	scheuen, Rücksicht nehmen
bi-sitan	herumsitzen, herumwohnen
bisitands	Nachbar
dis-sitan	ergreifen
ga-sitan	sich niedersetzen, Platz nehmen
us-sitan	sich aufsetzen, sich aufrichten
sitls	Sitz
siujan	nähen
siukan	siechen, krank sein
siukei	Krankheit
siuks	krank, schwach
siuns	Gesicht, das Sehen, Sehkraft; Gestalt, sinnfällige Erscheinung; Augenschein; Gesicht, Vision
skaban	schaben, scheren
bi-skaban	schaben, scheren
skadus	Schatten
ufar-skadwjan	überschatten
skaftjan	sich bereit machen
skaidan	scheiden, trennen
af-skaidan	absondern, abtrennen
dis-skaidan	zerteilen
ga-skaidan	sich zurückziehn
ga-skaidnan	geschieden werden
skal	schuldig sein, sollen
skalja*	Ziegel
skalkinassus	Knechtschaft, Dienst(barkeit); Gottesdienst
skalkinon	einem dienen
miþ-skalkinon	Mitknecht sein, mitdienen
skalks	Knecht, Diener
skaman	sich schämen
ga-skaman	beschämt werden
skanda	Schande
ga-skapjan	erschaffen
Skariotau	Skariotau
us-skarjan	daß sie nüchtern werden, zur Besinnung kommen aus den Schlingen des Teufels
skattja	Wechsler
skatts	Geld, Geldstück; Mine
†skaþaila	schädlich
skaþis	Schaden, Unrecht
skaþjan	schaden
ga-skaþjan	einem Schaden zufügen in
skaþuls	schädlich
skaudaraip	Riemen
skauns*	anmutig
skauneis*	skauneis*
skaurpjo	Skorpion
skauta	Zipfel
[us-skaujan]	daß sie nüchtern werden, zur Besinnung kommen aus den Schlingen des Teufels
skeimam	Leuchte
skeinan	scheinen, leuchten; aufblitzen
bi-skeinan	umleuchten
skeireins	Auslegung, Erklärung
ga-skeirjan	erklären
skeirs	klar, deutlich
skewjan	wandern
skildus*	Schild
skilja*	Fleischer
skilliggs	Schilling
skip	Schiff
af-skiuban	verstoßen, von sich wegstoßen
skohs	Schuh
skohsl	böser Geist, Dämon
dis-skreitan	etw. zerreißen
dis-skritnan	zerreißen
skufta	Haupthaar
skuggwa	Spiegel
skula	Schuldner, der Schuldige
skulan	schuldig sein, sollen
skūra	Schauer
Skwþus	Skwþus
slahals	Raufbold
slahan	schlagen
af-slahan	abschlagen
slahs	Schlag
slaihts	schlicht; glatt, eben
slauhts	das Schlachten
af-slaupjan	abstreifen, ablegen
af-slauþjan	in Angst versetzen
af-slauþnan	erschrecken
slawan	schweigen
ana-slawan	verstummen
ga-slawan	verstummen
sleiþa	Schaden
sleiþei	Gefahr
ga-sleiþjan	beschädigen
sleiþs*	schlimm, gefährlich
sleideis*	sleideis*
slepan	schlafen
ana-slepan	entschlummern, entschlafen
ga-slepan	entschlummern, entschlafen
sleps*	Schlaf
fra-slindan	verschlingen, verschlucken
sliupan	schleichen, schlüpfen
uf-sliupan	einschleichen
smairþr*	Fett
smakka	Feige
smakkabagms	Feigenbaum
smalista	der Kleinste
smarna	Mist, Kot
bi-smeitan	bestreichen
ga-smeitan	aufstreichen auf
ga-smiþon	(durch Schmieden) bewirken
smwrn*	Myrrhe
snaga	Gewand, Mantel
snaiws	Schnee
at-snarpjan	anfassen, anrühren
sneiþan	schneiden; ernten
†af-sneiþan	†af-sneiþan
uf-sneiþan	schlachten
sniumjan	eilen
ga-sniumjan	hineilen, kommen
sniumundo	eilends
sniumundos	eiliger
sniwan	eilen
du-atsniwan	hinzueilen
bi-sniwan	zuvorkommen
faur-bisniwan	vorangehn
faur-sniwan	vorwegnehmen
ga-sniwan	ereilen, gelangen zu
snorjo	Korb
snutrei	Weisheit
snutrs*	weise
so	der, dieser
sokareis	Forscher
sokeins	das Suchen
sokjan	suchen
ga-sokjan	aufsuchen
miþ-sokjan	mitdisputieren
us-sokjan	erforschen
sokns	Disputation, Streitfrage, Grübelei
Soseipatrus	Soseipatrus
soþa	Sättigung
ga-soþjan	ersättigen
spaikulatur	Späher, Ordonnanz
spaiskuldra	Speichel
sparwa	Sperling
spaurds	Rennbahn
speiwan	speien
and-speiwan	entgegenspeien
bi-speiwan	bespeien
ga-speiwan	ausspeien
spediza*	spät
spedists	der jüngste Tag
spedumists	spedumists
spilda	Tafel
spill	Sage, Fabel
spilla	Verkündiger
spillon	künden
ga-spillon	verkünden
þiuþ-spillon	Gutes, frohe Botschaft künden
us-spillon	verkünden, erzählen
waila-spillon	verkünden, erzählen
spinnan	spinnen
sprauto	schnell, bald
spwreidans	aus Binsen o. Palmblättern geflochtener Korb
stabeis	Grundstoffe, Elemente
†us-stagg	stich aus
ga-stagqjan	etwas anstoßen an
Staifanus	Staifanus
staiga	Steig, Weg
stainahs	steinig
staineins	steinern
stainjan	steinigen
stains	Stein
stairno	Stern
stairo	die Unfruchtbare
staks	Mal, Wundmal
and-staldan	einen versehn mit
ga-staldan	erwerben, bekommen
stamms	lallend, stammelnd
standan	stehn
af-standan	abstehn, ablassen, abfallen
and-standan	entgegenstehn, widerstehn, widerstreiten
at-standan	dabei stehn
bi-standan	herumstehn, umringen
faura-standan	Vorsteher
ga-standan	stehn bleiben, halt machen
in-standan	daß der Tag bevorsteht
miþ-standan	zusammenstehn mit
twis-standan	sich trennen, Abschied nehmen von
us-standan	sich erheben, aufbrechen, auferstehn
staþa	Ufer, Gestade
staþs	Stätte, Ort (Stelle im Buch); Raum, Platz
staua	Gericht, Urteil, Streitsache
staua	Richter
stauastols	Richterstuhl
ga-staurknan	vertrocknen
and-staurran	sie bezeigten ihr Unwillen
stautan	stoßen an
steigan	steigen
at-steigan	hinabsteigen
ga-steigan	hineinsteigen
ufar-steigan	darüber empor steigen
us-steigan	emporsteigen
stibna	Stimme
[usstigg]	stich aus
stigqan	stoßen
bi-stigqan	anstoßen an
ga-stiggqan	anstoßen
stikls	Becher, Kelch
stiks*	Stich, Punkt
stilan	stehlen
stiur	Stier, Kalb
stiurjan	aufstellen, geltend machen
stiwiti*	Geduld, geduldiges Ertragen
ana-stodjan	anfangen, anheben
du-stodjan	anfangen, anheben
stojan	stojan
ga-stojan	ein Urteil abgeben über (Akk.), beurteilen, (ver)urteilen
stols	Stuhl, Thron
stomin	Wesen, Gegenstand, Zuversicht, Erwartung
[ga-stoþan]	aufrecht erhalten
straujan	streuen
ga-straujan	bestreuen
uf-straujan	darunterstreuen, únterbreiten
striks	Strich
stubjus	Staub
sulja*	Sohle
ga-suljan	das Fundament legen, begründen
suman	teils __ teils __ teils
sums	irgend einer, ein gewisser, jemand, einer
sundro	abgesondert, besonders, allein
sunja	Wahrheit
Sunjaifriþas	Sunjaifriþas
sunjeins	wahr, wahrhaft
sunjis*	wahrhaft
sunjon	entschuldigen
ga-sunjon	rechtfertigen
sunjons	Verteidigung
sunno	Sonne
suns	alsbald, plötzlich, auf einmal
sunsaiw	sogleich
sunsei	sobald als
sunus	Sohn
supon	würzen
ga-supon	würzen
†suqnis	wegen deines Magens
Susanna	Susanna
sutis	nachgiebig, mild
suþjan	kitzeln
suþjon	suþjon
swa	so
swaei	so daß, daher, also
af-swaggwjan	schwankend machen
swah	so (auch)
swaihra	Schwiegervater
swaihro	Schwiegermutter
af-swairban	abwischen, auslöschen
bi-swairban	abwischen, abtrocknen mit
swalauþs	so groß
swaleiks	so beschaffen, ein solcher
swamm	Schwamm
swaran	schwören
bi-swaran	beschwören
ufar-swaran	falsch schwören
sware	ohne Grund, vergebens, umsonst
swartiza	Tinte
swartizla	swartizla
swarts	schwarz
swaswe	sowie, gleichwie, wie
swaþþan	so nun
swau	so
swe	wie
swegniþa	Jubel, Frohlocken
swegnjan	jubeln, triumphieren
sweiban	ablassen
swein	Schwein
sweran	ehren
ga-sweran	verherrlichen
un-sweran	verunehren, beschimpfen
sweriþa	Ehre
swers	geehrt, geachtet
swes	eigen, angehörig
swes	Eigentum, Vermögen
sweþauh	doch zwar, wenigstens
swibla	Schwefel
swiglja*	Flötenspieler
swiglon	Flöte blasen, aufspielen
swigniþa, swignjan	Jubel, Frohlocken
swiknei	Reinheit, Keuschheit
swikneins*	Reinigung
swikniþa	Reinheit, Keuschheit
swikns	rein, unschuldig; unsträflich
ga-swikunþjan	etw. bekannt geben
swikunþs	offenkundig, offenbar, bekannt
swiltan	im Sterben liegen
ga-swiltan	sterben
miþ-gaswiltan	miþ-gaswiltan
swinþei	Stärke, Kraft
ga-swinþjan	stärken
in-swinþjan	stärken
swinþnan	stark werden
ga-swinþnan	erstarken
swinþs	stark, kräftig, gesund
swistar	Schwester
Swmaion	Swmaion
swnagogafaþs*	Synagogenvorsteher
swnagoge*	swnagoge*
Swntwke*	Swntwke*
swogatjan	seufzen
ga-swogjan	erseufzen
uf-swogjan	aufseufzen
Swria*	Swria*
swultawairþja	dem Tode nahe
swumfsl	Teich
tagl	Haar
tagr	Zähre, Träne
tagrjan	weinen
tahjan	reißen, zerren
dis-tahjan	zerstreuen
taihswa	rechts
taihswa	die Rechte
taihun	zehn
taihunda	der zehnte
taihuntaihundfalþs	hundertfältig
taihuntehund	(dekadisches) Hundert
taihunteweis*	mit fünf zehnreihigen (dekadischen) Hundert
taikn	Anzeichnen
taiknjan	einem etwas Zeigen
ga-taiknjan	ein Zeichen geben, belehren
us-taiknjan	bezeichnen; auszeichnen; erweisen
taikns	Zeichen, Wunder
tainjo	(Weiden)korb
tains	Zweig
dis-tairan	zerreißen
ga-tairan	zerreißen, zerstören, aufheben
Tairtius	Tairtius
taitrarkes	taitrarkes
taleiþa	Mägdlein
talzeins*	Lehre, Unterweisung
talzjan	lehren, ziehen, unterrichten
talzjands	Lehrer
ga-talzjan	belehren, erziehen
ga-tamjan	bezähmen, bezwingen
tandjan	brennen machen, (an)zünden
ga-tandjan	mit einem Brandmal versehn
in-tandjan	in Brand setzen, verbrennen
ga-tarhjan	kennzeichnen
tarmjan	brich los, brich in Jubel aus
ga-tarnjan	berauben
taui	Werk, Tat
taujan	tun, machen
ga-taujan	(tun), vollbringen, bewirken
missa-taujan	Übeltäter
af-taurnan	abreißen
dis-taurnan	zerreißen
ga-taurnan	was zu nichte wird, das Vergängliche
Teibairius	Teibairius
ga-teihan	anzeigen, verkündigen
faura-gateihan	vorherverkündigen, vorhersagen
teikan	anrühren
Teimaius	Teimaius
Teimauþaius	Teimauþaius
Teitus	Teitus
tekan	anrühren
at-tekan	berühren
tewa*	Ordnung
ga-tewjan	durch Wahl bestimmt, verordnet
Tibairiadau	Tibairiadau
Tibairiadeis	Bewohner von Tiberias
tigjus*	Dekaden; bildet die Zehner von
and-tilon	einem anhangen
ga-tilon	erlangen
ga-gátilon	zusammenfügen
til	damit sie Gelegenheit fänden ihn anzuklagen
ga-timan	geziemen für (Dat.)
timbrjan	bauen
timreins	Erbauung
timrja	Zimmermann
timrjan	bauen
ana-timrjan	daraufbauen
ga-timrjan	erbauen
miþ-gatimrjan	mit
tiuhan	ziehn, (weg)führen
af-tiuhan	wegziehn
at-tiuhan	herbeiziehn, herbeiführen, herbeibringen
inn-attiuhan	hineinziehn, hineinführen
bi-tiuhan	(mit sich) umherführen
ga-tiuhan	wegziehn, wegführen
miþ-gatiuhan	mit
us-tiuhan	hinausführen, wegführen
Tobeias	Tobeias
Trakauneitidaus	Trakauneitidaus
trauains	Vertrauen, Zuversicht
trauan	trauen, Zutrauen haben
ga-trauan	vertrauen
Trauadai	Trauadai
trausti	Bündnis, Bund
triggwa	Bündnis, Bund
triggws	treu, zuverlässig
triggwaba	treulich, zuverlässig
trigo	Trauer
ana-trimpan	einen bedrängen
triu	Holz, Prügel
triweins	hölzern
trudan	treten
ga-trudan	zertreten
in-trusgjan	einpfropfen
ufar-trusnjan	überstreuen
tuggl	Gestirn
tuggo	Zunge
tulgiþa	Festigkeit, Sicherheit; Fundament (Grundfeste); Feste, Bollwerk
tulgjan	festigen, stärken
ga-tulgjan	befestigen, bestärken
tulgus	fest, beständig
tundnan	brennen
in-tundnan	verbrennen
tunþus	Zahn
twai	twai
twalibwintrus	zwölfjährig
twalif	zwölf
tweifleins	das Zweifeln
tweifljan	zweifeln o. Zweifel erregen
tweifl	Zweifel
tweihnai	zwischen beiden Grenzen
twisstass	Zwistigkeit
Twkeikus	Twkeikus
Twra*	Twra*
Þaddaius	Þaddaius
þadei	wohin
þagk*	Dank
þagkjan	denken, überlegen
and-þagkjan	mir fällt ein, was ich tun soll
bi-þagkjan	etw. bedenken
þahains	das Schweigen
þahan	schweigen
ga-þahan	verstummen
þāho	Lehm
Þaiaufeilus	Þaiaufeilus
þairh	durch
þairko	Loch, Nadelöhr
ga-þairsan	verdorren
Þaissaloneikai	Þaissaloneikai
Þaissalauneikaie	Þaissalauneikaie
þan	dann, darauf
þanamais	weiter, noch mehr
þanaseiþs	weiter, noch
þande	so lange als
þanei	wann
uf-þanjan	ausdehnen, sich ausstrecken
þank	Dank
þannu	ja, wohl, also darum
þanuh	þanuh
þar	dort
Þara	Þara
þarba	Mangel, Armut
ga-þarban	sich enthalten
þarbs	nötig
þarei	wo
þarf	nötig haben, bedürfen, Mangel leiden
þarihs*	ungewalkt
þaruh	da
þata	der, dieser
þatain	das eine
þatainei	nur
þatei	daß
þat-ist	das ist, nämlich
þatuh	der u. kein andrer, eben der
þaþro	daher, von da
þaþroei	von wannen
þaþroh	von da, daher
þau	als
þauhjabai	wenn auch
þaurban*	nötig haben, bedürfen, Mangel leiden
þaurfts	nötig
þaurfts	Bedürfnis, Not
þaurneins	von Dornen
þaurnus	Dorn
þaurp	bebautes Land, Acker
þaursjan	mich dürstet
af-þaursjan	(ver)dursten
ga-þaursnan	verdorren, vertrocknen
þaurstei	Durst
þaursus	dürr
þe	um so
þeei	darum, daß
þei	so lange als
þeihan	gedeihn, Fortschritte machen
ga-þeihan	vorwärtskommen
ufar-þeihan	übertreffen
þeihs	Zeit
þeiƕo	Donner
þeins	dein
þewisa	Knechte
at-þinsan	heranziehn
þishun	meist, vorzüglich
þisƕaduh	wohin auch immer
þisƕah	wer auch immer
þisƕaruh	wo auch immer
þisƕazuh	wer auch immer
þiubi	Diebstahl
þiubjo	verstohlen, heimlich
þiuda	Heiden
þiudangardi	Königsschloss
þiudanon	herrschen
miþ-þiudanon	mitherrschen mit
þiudans	König
þiudinassus	Regierung
þiudisko	heidnisch
þiufs	Dieb
þiumagus	Knecht
þius*	Haussklave, Diener
þiuþ	das Gute, die gute Sache
þiuþeigs	gut, gepriesen
þiuþeins	Güte
þiuqiss	Segen
þiuþjan	segnen
ga-þiuþjan	einem (Akk.) den Segen geben
un-þiuþjan	fluchen
þiwadw	Knechtschaft
ana-þiwan	unterjochen, in Dienstbarkeit bringen
ga-þiwan	unterjochen, in Dienstbarkeit bringen
þiwi	Magd
þlahsjan	schrecken
ga-þlahsnan	erschrecken
ga-þláihan	ermahnen
þlaqus	zart
þlauhs	Flucht
þliuhan	þliuhan
af-þliuhan	wegfliehn
ga-þliuhan	die Flucht ergreifen, entfliehn
unþa-þliuhan	entfliehn, einem entrinnen
Þomas	Þomas
þrafsteins	Tröstung
þrafstjan	trösten, mahnen
ana-þrafstjan	erquicken
ga-þrafstjan	ga-þrafstjan
þragjan	laufen
bi-þragjan	herbeilaufen
þramstei	Heuschrecke
þrasabalþei*	Streitsucht
þreihan	drängen
ga-þreihan	bedrängen
þreihsl	Teich
þreis*	drei
þridja	der dritte
þriskan	dreschen
us-þriutan	einem Beschwerde bringen
þroþjan	üben
us-þroþjan	Übung, Stählung
þrūtsfill	Aussatz
þrutsfills	aussätzig
þu	du
þuei	der du
þugkjan	glauben, meinen; gelten
þuhtus	Gewissen
þulains	das Dulden, Leiden, die Geduld
þulan	dulden
ga-þulan	erdulden
us-þulan	erdulden, ertragen
þūsundi	tausend
þusundifaþs	Anführer von Tausend
þuthaurn	Trompete
þuthaurnjan	trompeten
þwahan	etw. waschen
af-þwahan	sich abwaschen
bi-þwahan	sich abwaschen
us-þwahan	etwas auswaschen, abwaschen
þwahl	Bad, Taufe
þwairhei	Zorn, Streit, Streitigkeit
þwairhs	zornig
þwastiþa	Sicherheit
ga-þwastjan	befestigen
þwmiama	Rauchopfer
-u	-u
ubils	übel, böse
ubiltojis	übeltäterisch
ubilwaurdjan	schmähn
ubilwaurds	schmähsüchtig
ubizwa*	Halle
uf	unter
ufaiþeis*	durch Eid verpflichtet, verbunden
ufar	über
ufarassjan	überfließend, überschwänglich machen
ufarassus	Überfluß, Übermaß
ufarfullei	Überfülle, Überfluß
ufarfulls	übervoll
ufargudja	Oberpriester
ufarhauseins	das Überhören, der Ungehorsam
ufarhiminakunds	himmlisch
ufarjaina	darüber hinaus
ufarmaudei	Vergessenheit
ufarmeleins	Überschrift
ufarmeli	Überschrift
ufaro	darüber
ufarranneins	Besprengung
ufarskafts	Erstlingsfrucht
ufarswara*	Meineidiger
ufhauseins	Gehorsam
ufhnaiweins	Unterordnung, Gehorsam
Ufitahari	Ufitahari
ufjo	es ist überflüssig für mich euch zu schreiben
ufkunþi	Erkenntnis
ufswalleins	Aufgeblasenheit, Hochmut
ufta	oft
ufto	vielleicht
ufwaira	die verheiratete Frau
ugkis	uns beide(n)
-uh	und, nun, also
uhtedun	sich fürchten vor (Akk.)
uhteigs	Zeit habend
uhteigo	zur rechten Zeit
uhtiugs	gelegen
uhtwo	Morgendämmerung
ulbandus	Kamel
unagands	furchtlos
unagein	furchtlos
unairkns	unheilig, gottlos
unaiwisks	der sich nicht zu schämen braucht, ohne Schande
unanasiuniba	unsichtbar
unandhuliþs*	unenthüllt
unandsakans	unbestritten
unandsoks*	unbestreitbar
unatgāhts	unzugänglich
unbairands	nicht tragend
unbarnahs	kinderlos
unbaurans	ungeboren
unbeistei*	das Ungesäuertsein
unbeistjoþs*	ungesäuert
unbiari*	wildes Tier, Bestie
unbilaistiþs*	unaufspürbar, unbegreiflich
unbimait	Nichtbeschneidigung, Vorhaut
unbimaitans	unbeschnitten
unbrūks	unbrauchbar
und	bis zu
undar	unter etw
[undaristo]	das Innere
undarleija	der Allergeringste
undaro	unter
undaurnimats	Frühstück
undiwanei	Unsterblichkeit
unfagrs	unpassend, undankbar
unfairina	tadellos
unfairinodaba	untadelig
unfairlaistiþs	unaufspürbar, unerforschlich
unfaurs	geschwätzig
unfaurweis	unvorsätzlich, ohne Vorbedacht
unfraþjands	unverständig
unfreideins	Schonungslosigkeit, Härte
unfrodei	Unverstand, Torheit
unfroþs	unverständig
ungafairinonds	tadellos; unbescholten
ungafairinoþs	tadellos
ungahabands	zügellos, sich nicht beherrschend
ungahobains	Unmäßigkeit, Unenthaltsamkeit
ungaƕairbs	unfügsam, ungehorsam
ungakusans	nicht probehaltig, verwerflich
ungalaubeins	Unglaube, Ungehorsam
ungalaubjands	ungläubig, ungehorsam
ungalaufs	wertlos
ungaraihtei	Gesetzlosigkeit, Ungerechtigkeit
ungasaiƕans	ungesehn, unsichtbar
ungastoþs	ohne festen Stand, ohne bleibende Stätte
ungatass	ungeordnet, zügellos
ungatewiþs*	ungeordnet
ungawagiþs*	unbewegt, unbeweglich
unhabands	nicht habend
unhaili	Schwäche, Krankheit
unhails	krank
unhanduwaurhts	nicht mit der Hand gemacht
unhindarweis	ungeheuchelt
unhrainei	Unreinigkeit
unhrainiþa	Unreinigkeit
unhrains	unrein; ungebildet
unhulþa	Unhold, Teufel
unhulþo	Unholdin, Dämon
unhunslags	ohne Opfer, unversöhnlich
unƕapnands	unauslöschlich
unƕeila	unablässig
unkarja	sorglos
unkaureins*	unkaureins*
unkja	Unze
unkunnands	nicht kennend, unwissend
unkunþi	Unkunde
unkunþs	unbekannt
unledi	Armut
unleþs*	arm
unliufs*	ungeliebt, unlieb
unliugaiþs*	unverheiratet
unliugands	nicht lügend
unliuts	ungeheuchelt, ohne Falsch
unlustus	Unlust
unmahteigs	ohnmächtig, schwach
unmahts	Ohnmacht, Schwäche, Krankheit
unmanariggwai	ungezähmt, wild oder unfreundlich, barsch
unmanwus	unvorbereitet
unmildjai	lieblos
unnutjans	unnütz, töricht
unqeniþs*	unbeweibt
unqeþs*	unaussprechlich
unriurei	Unvergänglichkeit
unriureis*	unvergänglich
unriurs*	unriurs*
unrodjands	nicht redend, stumm
[unsahtaba]	unbestritten
unsaiƕands	nicht sehend
unsaltans	ungesalzen
unsar	unser
unselei	Bosheit, Schlechtigkeit
unsels	übel, böse
unsibjis*	ungesetzlich, gottlos
unskaus*	laßt uns nüchtern sein
unsuti*	Aufstand
unsweibands	unaufhörlich
unswerei	Unehre
unsweriþa	Unehre
unswers	nicht geachtet, verachtet
unswikunþs*	unbekannter
untals	unfügsam, unbotmäßig, ungehorsam
unte	bis, so lange als
untilamalsks	voreilig, unbesonnen
untriggws	untreu
unþiuda	Unvolk, Nicht
unþiuþ	das Böse
unþwahans	ungewaschen
unufbrikands	unanstößig
unuhteigo	zur Unzeit
unuslaisiþs	unbelehrt
unusspilloþs*	nicht auszuerzählen, unerforschlich
unwahs	tadellos
unwairþaba	unwürdig
unwammei	Unbeflecktheit
unwamms	fleckenlos, tadellos
unwaurstwo	untätig, müßig
unweis	ungebildet, unwissend
unweniggo	unerwartet, plötzlich
unwerein	Unwille
[unwiss*]	ungewiß, ins ungewisse
unwita	Unwissender, Unverständiger
unwitands	unwissend
unwiti	Unwissenheit, Unverstand
unwunands	beängstigt, bekümmert
ur	aus, von ( __ her)
urrists	Auferstehung
urrugks	verworfen
urruns	Abtritt
urruns	Ausgang
us	aus, von ( __ her)
usbalþei	Frechheit; fortwährende Zänkerei
usbeisnei	Geduld, Langmut
usbeisneigs	geduldig, langmütig
usbeisns	Erwartung; Geduld, Langmut
us-bloteins	Bitte, Flehn
usdaudei	Ausdauer; Eifer
usdauþs*	eifrig
usdaudoza	usdaudoza
usdaudo	eifrig
usdrusts	rauhe Wege
usfairina	tadellos
usfarþo	Ausfahrt
usfilh	Begräbnis
usfilma	sie entsetzten sich über
usfilmei	Entsetzen
usfodeins	Nahrung
usfulleins	Erfüllung
usgrudja	mutlos
ushaista	Mangel leidend
uskunþs	bekannt, offenbar
uslauseins	Erlösung
usliþa	gichtbrüchig, Gichtbrüchiger
†uslukns	erschließen, öffnen
usluk*	Eröffnung, Öffnung
usluneins*	Erlösung
usmet*	Lebensführung; Lebenswandel
usqiss	Beschuldigung, Anklage
ussateins	Ursprung
ussindo	am meisten, besonders
[usskawai]	laßt uns nüchtern sein
usstass	Auferstehung
usstiurei	Zügellosigkeit, Lüderlichkeit
usstiuriba	zügellos
ustaikneins	Auszeichnung, Bezeichnung; Bekanntmachung; Anzeichen, Beweis
ustauhts	Vollendung, Vervollkommnung; Ende; Erfüllung
usþroþeins	Übung, Stählung
usþulains	Geduld
uswahsans	erwachsen
uswahsts	Wachstum
uswalteins	Umwälzung; Zusammensturz; Zerstörung; Untergang
uswandi*	das Abwenden, Irreleiten
uswaurhts	gerecht
uswaurhts	Gerechtigkeit
uswaurpa	Auswurf; Verwerfung; Fehlgeburt
usweihs	außer der Weihe
uswena	hoffnungslos
uswiss	losgebunden
uswissi*	Leichtfertigkeit, Eitelkeit
ūt	hinaus, heraus
ūta	außerhalb, draußen
ūtana	von außen, außen
ūtaþro	von außen
uzeta*	Krippe
uz-u, uz-uh	aus, von ( __ her)
wadi	Pfand
wadjabokos	Handschein, Schuldschein
ga-wadjon	zusammenfügen, verloben
waggarja	Kopfkissen
waggs*	Paradies
wagjan	schütteln
af-wagjan	bewegen, abbringen
ga-wagjan	einen in Bewegung setzen
in-wagjan	erregen, aufwiegeln
us-wagjan	erregen
wahsjan	wachsen
ufar-wahsjan	überaus wachsen, sich stark vermehren
us-wahsjan*	erwachsen
wahstus	Wuchs
wahtwom	Wache
wai	wehe
waian	wehn
bi-waibjan	umwinden, umgeben, umkleiden
waidedja	Übeltäter, Räuber
waihjo	Kampf
waihsta	Winkel, Ecke
waihstastains	Eckstein
waiht	nichts
waihts	Ding, Sache, Etwas
wáila	wohl, gut
wailadeþs*	Wohltat
wailamerei*	guter Ruf
wailamereins	Verkündigung
wailamereis	wohllautend, löblich
wailaqiss	Segen
wailawizns	victus, gute Nahrung
wainahs	elend, geplagt
wainei	daß doch, wenn doch
faur-waipjan	verbinden
waips	Kranz
wair	Mann
wairaleiko	männlich
wairdus	Gastfreund, Hauswirt
wairilom	Lippe
wairpan	werfen
af-wairpan	etw. wegwerfen
at-wairpan	hinwerfen
fra-wairpan	verwerfen, zerstreuen
ga-wairpan	hinwerfen
inn-wairpan	hineinwerfen
us-wairpan	hinauswerfen, wegwerfen, austreiben
wairs	schlimmer
wairsiza	schlimmer
wairþ	Preis
wairþan	werden
fra-wairþan	verderben
wairþida	Tüchtigkeit, Fähigkeit
ga-gáwairþjan	versöhnen mit
ga-gáwairþnan	sich versöhnen mit
wairþon	schätzen
wairþs	wert, würdig, tauglich
wait	auf etw. sehn, acht geben, es bewachen, hüten, etw. halten
waitei	vielleicht, etwa
wajamerei	schlechter Ruf
wajamereins	Lästerung
wakan	wachen
þairh-wakan	durchwachen
us-wakjan	erwecken
ga-waknan	erwachen
waldan	walten
ga-waldan	sich der Herrschaft bemächtigen, einen vergewaltigen
waldufni	Gewalt, Macht über
walisa	echt, lauter
waljan	wählen
ga-waljan	erwählen
waltjan	sich wälzen
us-waltjan	etw. umwälzen, umstürzen
us-walugjan	hin und her wälzen
walus	Stab
walwison	sich wälzen
af-walwjan	wegwälzen
at-walwjan	hinzuwälzen
faur-walwjan	vorwälzen
wamba	Bauch, Schoß
wamme	Fleck
ana-wammjan	beflecken
wan	Mangel
wanains	Mangel
wandjan	wenden
af-wandjan	abwenden
at-wandjan	zuwenden
bi-wandjan	vermeiden
ga-wandjan	(hin)wenden
in-wandjan	verdrehn
us-wandjan	sich wegwenden
wandus	Rute
waninassus	Mangel
wans	mangelhaft, fehlend
wardja	Wächter
fra-wardjan	verderben
warei	Tücke, Verschlagenheit
wargiþa	Verdammungsurteil, Verurteilung
ga-wargjan	einen verurteilen zu (Dat.)
warjan	wehren
warmjan	wärmen
warai*	behutsam, nüchtern
wasjan	einen kleiden
and-wasjan	entkleiden
ga-wasjan	bekleiden mit
wasti*	Kleid
wato	Wasser
waurd	Wort
waurdahs	seiner vernünftigen Natur gemäß
waurdajiuka	Wortstreit
and-waurdjan	widersprechen
filu-waurdjan	viel Worte machen
ubil-waurdjan	schmähn
waurkjan	machen, wirken
fair-waurkjan	etw. erwirken
fra-waurkjan	eine Sünde begehen
ga-waurkjan	bewirken, erwirken, bereiten
us-waurkjan	ausführen, vollbringen
waurms	Wurm, Schlange
waurstw	Werk, Tat; Wirksamkeit
waurstwa	Arbeiter
waurstwei	das Tun
waurstweigs	wirksam
waurstwja	Arbeiter
waurts	Wurzel
wegs	Erschütterung, Sturm; Wellenschlag, Brandung
weiha	Priester
weihan	kämpfen
and-waihan*	widerstreiten
weihan	weihen, heiligen
ga-weihan	weihen, heiligen
weihiþa	Weihe, Heiligung, Heiligkeit
weihnan	heilig werden
weihs	heilig
weihs	Dorf, Weiler
wein	Wein
weinabasi	Weinbeere
weinagards	Weingarten, Weinberg
weinatains	Weinrebe
weinatriu	Weinstock
weindrugkja	Weintrinker, Säufer
weinnas	trunken, Trunkenbold
weipan	kränzen, krönen
weis	wir
fullaweisjan	überreden
ga-fullaweisjan	vollenden oder beglaubigen
ga-weison	heimsuchen, besuchen, besorgen
fra-weitan	einem Recht verschaffen, ihn rächen an
in-weitan	die Proskynesis, Verehrung erweisen, begrüßen
fair-weitjan	gespannt hinblicken auf
idweitjan	schmähn
weitwodei	Zeugnis
weitwodeins	Zeugnisablegung, Zeugnis
weitwodi	Zeugnis
weitwodiþa	Zeugnisablegung, Zeugnis
weitwodjan	zeugen, bezeugen
miþ-weitwodjan	mitzeugen
weitwoþs*	Zeuge
wenjan	warten, hoffen auf (Akk.)
faura-wenjan	auf einen vorher hoffen
ga-wenjan	erwarten, annehmen
wens	Hoffnung
wepna	Waffen
Wereka	Wereka
tuz-werjan	zweifeln
un-werjan	unwillig sein, zürnen
ga-widan	zusammenbinden, verbinden
in-widan	verleugnen
widuwairna*	Waise
widuwo	Witwe
wigadeinom	Dornpflanzen
ga-wigan	bewegen
[wigana]	zum Kriege
wigs	Weg
wiko	in der Reihenfolge seiner Tagesklasse, da seine Tagesklasse an der Reihe war
wilja	Wille
wiljahalþei	Parteilichkeit
wiljan	wollen
Wiljariþ	Wiljariþ
wilþeis	wild
wilwa	räuberisch, Räuber
wilwan	rauben
dis-wilwan	ausplündern, berauben
fra-wilwan	fortreißen
bi-windan	umwinden
du-gawindan	du-gawindan
us-windan	flechten
winds	Wind
winja	Weide
winna	Leiden
winnan	leiden
ga-winnan	erleiden
winno	Leiden
wintrus	Jahr
winþiskauro	Worfschaufel
dis-winþjan	zermalmen
wipja	Kranz
wis	Meeresstille
wisan	sein, dasein, existieren
at-wisan	da sein
faura-wisan	vorhanden ist
fra-wisan	verbrauchen, vergeuden
in-wisan	als der Sabbat vorüber war
miþ-wisan	beistehn, zu Hilfe kommen
ufar-wisan	überragend sein
wisan	sich freuen, schwelgen, schmausen
bi-wisan	sich freuen, schwelgen, schmausen
wisan	weilen, bleiben
ga-wisan	verweilen, verbleiben
miþ-gawisan	mit einem zusammen verweilen
þairh-wisan	verbleiben, verharren
wists	Wesen, Natur
wit	wit
witan	wissen
miþ-witan	ich bin mir nichts bewußt
witan	auf etw. sehn, acht geben, es bewachen, hüten, etw. halten
witodafasteis	Gesetzeskundiger
witodalaisareis	Gesetzeslehrer
witodalaus	gesetzlos
witodeigo	gesetzlich
witoþ	Gesetz
witubni	Kenntnis, Erkenntnis
wiþon	schütteln
wiþra	wider, gegen
wiþrawairþs	gegenüberliegend, entgegengesetzt
wiþrus	(Widder) Lamm
wizon	die Schwelgende
wlaiton	sich umsehn
wlits	Angesicht; Ansehn, Gestalt
wlizjan	ins Gesicht schlagen, kasteien
Wmainaius	Wmainaius
wokains	das Wachen
wokra	Zins
wopjan	rufen
at-wopjan	herbeirufen
uf-wopjan	aufschreien, ausrufen
woþeis*	angenehm
woþs*	wütend, besessen
wraiqs	krumm
wraka	Verfolgung
wrakja	Verfolgung
wrakjan	verfolgen
wraks	Verfolger
wratodus	Reise
wraton	reisen
wrekei	Verfolgung
[wreþus]	Herde
wrikan	verfolgen
fra-wrikan	verfolgen
ga-wrikan	bestrafen, Rache nehmen an (Akk.)
ga-wrisqan	Frucht bringen
writs	Strich
wriþus	Herde
wrohjan	anklagen, beschuldigen
fra-wrohjan	verklagen, verdächtigen
wrohs	Klage, Anklage gegen
wruggo	Schlinge
wulan	wallen, sieden
wulfs	Wolf
wulla	Wolle
wullareis	Tuchwalker
wulþags	herrlich, wunderbar
wulþriza	wertvoller
wulþrs	Wert
wulþus	Herrlichkeit
wulwa	Raub
[ga-wundon]	verwunden
wunds	wund
wundufni	Geißel, Plage
wunns	Leiden
Xafira	Xafira
Xreskus	Xreskus
Xristus	Christus
Zaibaidaius	Zaibaidaius
Zakarias	Zakarias
Zakkaius	Zakkaius
Zauraubabil	Zauraubabil
Zaxxaius	Zaxxaius
Zelotes*	Eiferer, Beiname des Simon
