form	sense	pos
†Aai	†Aai	<none>
aba	Ehemann	Noun, common, masculine
abba	Vater	Foreign word
Abeileni	Abeileni	Noun, proper
Abia*	Abia*	Noun, proper
Abiaþar	Abiaþar	Noun, proper
Abraham	Abraham	Noun, proper
bi-abrjan	vor Furcht, Staunen außer sich geraten über	Verb
abrs	stark, heftig	Adjective
abraba	sehr	Adverb, Comparative
abu	von, von __ weg, von __ her	<none>
Adam	Adam	Noun, proper
Addei*	Addei*	Noun, proper
Addin	Addin	Noun, proper
Adoneikam*	Adoneikam*	Noun, proper
af	von, von __ weg, von __ her	Preposition, +D
afar	nachher	Adverb
[afara]	Nachkomme	Noun, common, masculine
afardags	der folgende Tag	Noun, common, masculine
afarsabbate	des Nachsabbats d.h. des ersten Wochentags	Noun, common
afdauiþs*	geplagt	Participle, past
afdomeins	Verdammung	Noun, common, feminine
afdrugkja	Trunkenbold	Noun, common, masculine
afetja	Fresser	Noun, common, masculine
afgrundiþa	Abgrund	Noun, common, feminine
afgudei	Gottlosigkeit	Noun, common, feminine
afguþs*	abgöttisch, gottlos	Adjective
afhaimeis*	der Heimat fern	Adjective
aflageins	Ablegung, Erlaß	Noun, common, feminine
aflet*	Erlaß	Noun, common, neuter
afmarzeins	Betrug	Noun, common, feminine
afmauiþs*	ermüdet	Participle, past
afsateins	Absetzung	Noun, common, feminine
afstass	Abfall	Noun, common, feminine
afta	hinten	Adverb, locative
aftana	von hinten	Adverb, directional
aftaro	von hinten	Adverb
aftra	wieder	Adverb
aftraanastodeins	Wiederanfang, Wiedererneuerung	Noun, common, feminine
aftuma	letzter	Adjective, Comparative
aftumists	letzter	Adjective, Superlative
-agan	furchtlos	Verb
Agar	Agar	Noun, proper
aggilus	Engel, Bote	Noun, common, masculine
aggwiþa	Bedrängnis 	Noun, common, feminine
ga-aggwjan	bedrängen	Verb
aggwus	eng	Adjective
agis	Furcht, Schrecken	Noun, common, neuter
af-agjan	ängstigen	Verb
in-agjan	einen anfahren	Verb
us-agjan	einen erschrecken	Verb
aglaitei	Unzucht	Noun, common, feminine
aglaitgastalds	schmutzig gewinnsüchtig	Adjective
aglaiti*	Unzucht	Noun, common, neuter
aglaitiwaurdei	Schandrede	Noun, common, feminine
agliþa	Drangsal	Noun, common, feminine
us-agljan	 bedrängen	Verb
aglo	Drangsal	Noun, common, feminine
agls	schimpflich	Adjective
aglus	schwierig	Adjective
agluba	agluba	Adverb, Comparative
Agustus	Agustus	Noun, proper
aha	Sinn, Verstand	Noun, common, masculine
ahaks	zahme  Taube	Noun, common
ahana	Spreu	Noun, common, feminine
Aharon	Aharon	Noun, proper
ahjan	meinen	Verb
ahma	Geist	Noun, common, masculine
ahmateins	Inspiration	Noun, common, feminine
ahmeins	geistig, geistlich	Adjective
ahs	Ähre	Noun, common, neuter
ahtau	acht	Numeral, cardinal
ahtaudogs	achttägig	Adjective
ahtautehund	achtzig	Numeral, cardinal
ahtuda	der achte	Numeral, cardinal
aƕa	Fluß, Gewässer	Noun, common, feminine
[Aia]	[Aia]	Noun, proper
Aibair	Aibair	Noun, proper
†aibr	Opfergabe	Noun, common
Aiddua	Aiddua	Noun, proper
Aieira	Aieira	Noun, proper
Aifaisius*	Aifaisius*	Noun, proper
Aifaiso*	Aifaiso*	Noun, proper
aiffaþa	öffne dich	Foreign word
aigan*	haben	Verb
fair-aihan	teilhaben an	Verb
aigin	Eigentum	Noun, common, neuter
ga-aiginon	In Besitz nehmen	Verb
aihtron	betteln; für sich verlangen	Verb
aihtrons	Gebet	Noun, common, feminine
aihts	Eigentum	Noun, common, feminine
aiƕatundi	Dornstrauch	Noun, common, feminine
af-aikan	leugnen	Verb
aikklesjo	Gemeinde, Kirche; Gotteshaus	Noun, common, feminine
Ailam	Ailam	Noun, proper
Aileiaizair	Aileiaizair	Noun, proper
Aileiakeim	Aileiakeim	Noun, proper
Aileisabaiþ	Aileisabaiþ	Noun, proper
ailoe	ailoe	Foreign word
[Ailul]	[Ailul]	<none>
Aimmeira*	Aimmeira*	Noun, proper
ainabaur	eingeboren	Noun, common, masculine
ainaha	einzig	Adjective
ainakls	vereinzelt, alleinstehend	Adjective
ainamundiþa	Einheit, Einmütigkeit	Noun, common, feminine
[ga-ainan]	vereinzeln, trennen	Verb
ainfalþei	Einfalt	Noun, common, feminine
ainfalþs	einfach	Adjective
ainfalþaba	einfältig	Adverb, Comparative
ainƕarjizuh	ein jeder	Pronoun, indefinite
ainƕaþaruh*	jeder von beiden	Pronoun, indefinite
ainlif*	elf	Numeral, cardinal
Ainnaa	Ainnaa	Noun, proper
Ainok	Ainok	Noun, proper
Ainos	Ainos	Noun, proper
ains	ains	Adjective
ainshun	niemand, keiner	Pronoun, indefinite
Aiodia	Aiodia	Noun, proper
Aipafras	Aipafras	Noun, proper
Aipafraudeitus	Aipafraudeitus	Noun, proper
aipiskaupei*	Bischofsamt	Noun, common, feminine
aipiskaupus	Bischof	Noun, common, masculine
aipistaule	Brief	Noun, common
áir	früh	Adverb, temporal
airis	längst, eher	Adverb, Comparative
Airastus	Airastus	Noun, proper
airinon	Gesandter sein, unterhandeln	Verb
áirizans	Vorfahren	Adjective, Comparative
[airkns]	heilig	Adjective
airkniþa	Lauterkeit, Echtheit	Noun, common, feminine
Airmodam	Airmodam	Noun, proper
Airmogaineis	Airmogaineis	Noun, proper
airþa	Erde, Land	Noun, common, feminine
airþakunds	von irdischer Abkunft	Adjective
airþeins	irdisch	Adjective
airus	Bote	Noun, common, masculine
airzei	Irrlehre	Noun, common, feminine
airzeis*	irre geführt	Adjective
airziþa	Irrlehre	Noun, common, feminine
airzjan	irre führen	Verb
af-airzjan	irre machen	Verb
aistan	sich scheuen vor	Verb
ga-aistan	sich scheuen vor	Verb
aiþei	Mutter	Noun, common, feminine
aiþs	Eid	Noun, common, masculine
aiþþau	oder	Conjunction
aiwaggeli	Evangelium	Noun, common, neuter
aiwaggelista	aiwaggelista	Noun, common, masculine
aiwaggeljan	das Evangelium verkünden	Verb
aiwaggeljo	Evangelium	Noun, common, feminine
aiweins	ewig	Adjective
aiwiski	Schande	Noun, common, neuter
aiwiskon	schändlich handeln	Verb
ga-aiwiskon	beschämen, beschimpfen	Verb
us-aiwjan	sich anstrengen	Verb
aiwlaugia	Segen 	Noun, common, masculine
Aiwneikai	Aiwneikai	Noun, proper
aiws	Zeit, Ewigkeit	Noun, common, masculine
Aiwwa	Aiwwa	Noun, proper
aiwxaristia	Dank	Noun, common
aiz	Erz	Noun, common, neuter
Aizaikeia	Aizaikeia	Noun, proper
aizasmiþa	Erzschmied	Noun, common, masculine
Aizleim	Aizleim	Noun, proper
Aizor	Aizor	Noun, proper
ajukdūþs*	Ewigkeit	Noun, common, feminine
ak	sondern	Conjunction
Akaja	Akaja	Noun, proper
Akajus*	Akajus*	Noun, proper
Akaïkus	Akaïkus	Noun, proper
akei	aber	Conjunction
aket*	Essig	Noun, common
akran	Frucht	Noun, common, neuter
akranalaus	unfruchtbar	Adjective
akrs	Acker	Noun, common, masculine
Akwla	Akwla	Noun, proper
alabalstraun	Salbenbüchse aus Alabaster	Noun, common
alabrunsts	Brandopfer	Noun, common, feminine
Alaiksandrus	Alaiksandrus	Noun, proper
alakjo	insgesamt	Adverb
alamans*	Gesamtheit der Menschen	Noun, common, masculine
alamannans*	alamannans*	<none>
Alamod	Alamod	Noun, proper
alan	wachsen	Verb
alaþarba	an allem Mangel leidend	Adjective
aldomin	Alter	Noun, common
alds	Menschenalter, Zeit	Noun, common, feminine
aleina	Elle	Noun, common, feminine
alew*	Öl	Noun, common, neuter
alewabagms	Ölbaum	Noun, common, masculine
alewja	Öl	Adjective
Alfaius	Alfaius	Noun, proper
alhs	Tempel	Noun, common, feminine
alja	außer	Conjunction
aljakuns	anderswoher stammend	Adjective
aljaleiko	anders	Adverb
aljaleikos	anders	Adverb, Comparative
[aljaleikoþs]	anders gebildet, allegorisch	Participle, past
aljan	mästen	Verb
aljan	Eifer	Noun, common, neuter
aljanon	eifern	Verb
in-aljanon	zornig machen	Verb
aljar	anderswo	Adverb, locative
aljaþ	anderswohin	Adverb, directional
aljaþro	anderswoher	Adverb, directional
aljis*	ein andrer	Adjective
allandjo	völlig	Adverb
allaþro	von allen Seiten her	Adverb, directional
allawaurstwa	vollkommen	Noun, common, masculine
allawerei	Redlichkeit	Noun, common, feminine
allis	überhaupt	Adverb
alls	all, jeder, ganz	Adjective
allwaldands	Allmächtiger	Noun, common, masculine
us-alþan	alt werden	Verb
alþeis	alt	Adjective
[Alul]	[Alul]	Noun, proper
Ameinadab*	Ameinadab*	Noun, proper
amen	amen	Foreign word
Ammo*	Ammo*	Noun, proper
ams*	Schulter	Noun, common, masculine
amsa*	amsa*	Noun, common, masculine
an	denn, nun	Particle
ana	darauf, außerdem	Adverb
anabusns	Gebot	Noun, common, feminine
anafilh	Empfehlung, Überlieferung	Noun, common, neuter
anahaimeis*	in der Heimat befindlich	Adjective
anaks	plötzlich	Adverb, temporal
anakunnains	Lesung	Noun, common, feminine
analageins	Auflegung	Noun, common, feminine
analaugnei	Verborgenheit	Noun, common, feminine
analaugns	verborgen	Adjective
analeiko	auf gleiche Weise	Adverb
anamahts	Übermacht, Mißhandlung	Noun, common, feminine
anaminds	versteckte Meinung, vermutung	Noun, common, feminine
uz-anan	ausatmen	Verb
Ananias*	Ananias*	Noun, proper
Ananeias*	Ananeias*	<none>
ananiujiþa*	Erneuerung	Noun, common, feminine
anaqal	Ruhe	Noun, common
anaqiss	Lästerung	Noun, common, feminine
anasiuns	sichtbar	Adjective
anastodeins	Anfang	Noun, common, feminine
anaþaima	anaþaima	Foreign word
Anaþoþ	Anaþoþ	Noun, proper
anawairþs	zukünftig	Adjective
anawiljei	Billigkeit	Noun, common, feminine
and	entlang, über __ hin, auf __ hin	Preposition, +A
andabauhts	Lösegeld	Noun, common, feminine
andabeit	Tadel	Noun, common, neuter
andahafts	Antwort; Verteidigung	Noun, common, feminine
andahait	Bekenntnis	Noun, common, neuter
andalauni	Gegenlohn; Vergeltung	Noun, common, neuter
andanahti	Abend	Noun, common, neuter
andaneiþa	feindlich	Noun, common, masculine
andanem	das Empfangen	Noun, common, neuter
andanemeigs	festhaltend	Adjective
andanems	angenehm	Adjective
andanumts	Aufnahme, Annahme; Erhebung	Noun, common, feminine
andasets	verabscheuungswert	Adjective
andastaþjis	Widersacher	Noun, common, masculine
andastaua	Gegner vor Gericht	Noun, common, masculine
andaþāhts	nüchtern, verständig	Adjective
andaugi	Antlitz	Noun, common, neuter
andaugiba	freimütig, offen	Adverb
andaugjo	offen	Adverb
andawairþi	Preis	Noun, common, neuter
andawaurdi	Antwort	Noun, common, neuter
andawizns	Sold; Notdurft	Noun, common, feminine
andawleizn*	Angesicht	Noun, common, neuter
andbahti	Amt, Dienst	Noun, common, neuter
andbahtjan	etwas  leisten	Verb
andbahts	Diener	Noun, common, masculine
andeis	Ende	Noun, common, masculine
andhuleins	Enthüllung, Offenbarung	Noun, common, feminine
andilaus	endlos	Adjective
andizuh	anders, sonst	Conjunction
Andraias	Andraias	Noun, proper
andstald*	Darbietung, Beistand	Noun, common, neuter
andwairþi	Gegenwart, Angesicht, Person	Noun, common, neuter
andwairþs	gegenwärtig	Adjective
Anna	Anna	Noun, proper
Annas	Annas	Noun, proper
anno*	Sold	Noun, common, feminine
Ano*	Ano*	Noun, proper
ans*	Balken	Noun, common, masculine
ansteigs	gnädig	Adjective
ansts	Freude; Dank; Gnade, Gunst	Noun, common, feminine
Antiaukia*, Antiokia*	Antiaukia*, Antiokia*	Noun, proper
anþar	anderer, zweiter	Adjective
anþarleikei	Verschiedenheit	Noun, common, feminine
anþarleiko	anders	Adverb
Appaullo*	Appaullo*	Noun, proper
apaustaulei	Apostolat	Noun, common, feminine
apaustaulus	Apostel	Noun, common, masculine
aqizi	Axt	Noun, common, feminine
ara	Aar	Noun, common, masculine
Arabia	Arabia	Noun, proper
Araita*	Araita*	Noun, proper
Aram	Aram	Noun, proper
arbaidjan	arbeiten; dulden	Verb
bi-arbaidjan	seine Ehre setzen in, trachten nach	Verb
miþ-arbaidjan	mit Jem. arbeiten; mit Jem. leiden	Verb
þairh-arbaidjan	dúrcharbeiten	Verb
arbaiþs	Arbeit, Drangsal	Noun, common, feminine
arbi	das Erbe	Noun, common, neuter
arbinumja	der Erbe	Noun, common, masculine
arbja	der Erbe	Noun, common, masculine
arbjo	Erbin	Noun, common, feminine
Areimaþaia	Areimaþaia	Noun, proper
Areistarkus	Areistarkus	Noun, proper
Arfaksad*	Arfaksad*	Noun, proper
arƕazna	Pfeil	Noun, common, feminine
arjan	pflügen	Verb
arka	hölzerner Kasten, Arche; Futteral, Beutel	Noun, common, feminine
arkaggilus	Erzengel	Noun, common, masculine
Arkippus	Arkippus	Noun, proper
armahairtei	Barmherzigkeit	Noun, common, feminine
armahairtiþa	Almosen	Noun, common, feminine
armahairts	barmherzig	Adjective
armaio	Barmherzigkeit	Noun, common, feminine
arman	sich eines erbarmen	Verb
ga-arman	sich eines erbarmen	Verb
arms*	arm, beklagenswert	Adjective
arms	Arm	Noun, common, masculine
arniba	sicher	Adverb
aromata	aromata	Noun, common
[Artaksairksus]	[Artaksairksus]	Noun, proper
arwjo	umsonst	Adverb
Asaf*	Asaf*	Noun, proper
asans	Sommer	Noun, common, feminine
Aser*	Aser*	Noun, proper
Asgad*	Asgad*	Noun, proper
Asia	Asia	Noun, proper
asiluqairnus	Eselsmühle	Noun, common, feminine
asilus	Esel	Noun, common, masculine
Asmoþ	Asmoþ	Noun, proper
asneis	Mietling, Tagelöhner	Noun, common, masculine
assarjus*	Aß, Pfennig	Noun, common, masculine
Assaum	Assaum	Noun, proper
astaþ	Sicherheit	Noun, common
asts	Ast	Noun, common, masculine
at	von	Preposition, +AD
ataþni*	Jahr	Noun, common, neuter
Ater*, Ateir*	Ater*, Ateir*	Noun, proper
atgagg*	Zugang	Noun, common, neuter
atisk	Saat	Noun, common
fra-atjan	zum Essen austeilen	Verb
atta	Vater	Noun, common, masculine
atwitains*	das Beobachten	Noun, common, feminine
Aþeinim	Aþeinim	Noun, proper
aþnam	Jahre	Noun, common
aþþan	aber doch	Conjunction
audagei	Seligkeit	Noun, common, feminine
audagjan	selig preisen	Verb
audags	selig	Adjective
audahafts	beglückt	Adjective
aufto	allerdings; wohl; vielleicht	Adverb
augadauro	Fenster	Noun, common, neuter
augjan	zeigen	Verb
at-augjan	einem  zeigen	Verb
augo	Auge	Noun, common, neuter
auhjodus	Lärm	Noun, common, masculine
auhjon	lärmen	Verb
auhns*	Ofen	Noun, common, masculine
auhsa	Ochse	Noun, common, masculine
auhsus	Ochse	Noun, common, masculine
auhuma	höher	Adjective, Comparative
auhumists	höchster	Adjective, Superlative
auk	denn, nämlich	Conjunction
aukan	sich mehren	Verb
ana-aukan	hinzufügen zu	Verb
bi-aukan	hinzufügen	Verb
ga-aukan	sich vermehren, zunehmen	Verb
auknan	sich mehren	Verb
bi-auknan	sich vermehren, zunehmen	Verb
Auneiseifaurus	Auneiseifaurus	Noun, proper
Aunisimus	Aunisimus	Noun, proper
aurahjom	Grabdenkmäler, Gräber	Noun, common
aurali*	Schweißtuch	Noun, common, neuter
aurkjus*	Krug	Noun, common, masculine
aurkeis*	aurkeis*	Noun, common, masculine
aurtigards	Garten	Noun, common, masculine
aurtja	Landmann, Winzer	Noun, common, masculine
auso	Ohr	Noun, common, neuter
auþida	Wüste	Noun, common, feminine
auþeis*	öde	Adjective
auþs*	auþs*	<none>
aweþi	Schafherde	Noun, common, neuter
awiliudon	einem  danken	Verb
awiliuþ	Dank	Noun, common, neuter
awistr*	Schafstall	Noun, common, neuter
awo	Großmutter	Noun, common, feminine
Axaïa	Axaïa	<none>
azetjam	üppig lebend	Noun, common
azets*	leicht	Adjective
azgo	Asche	Noun, common, feminine
azwme	am Tage der ungesäuerten Brode	Noun, common
-ba	wenn	Conjunction, enclitic
Babawis	Babawis	Noun, proper
badi	Bett	Noun, common, neuter
Bagauis	Bagauis	Noun, proper
bagms	Baum	Noun, common, masculine
bai	beide	Numeral, other
Baiailzaibul	Baiailzaibul	Noun, proper
baidjan	einen  zwingen	Verb
ga-baidjan	einen  zwingen	Verb
Baidsaiïdan	Baidsaiïdan	<none>
Bailiam	Bailiam	Noun, proper
Bainiamein	Bainiamein	Noun, proper
bairabagms	Maulbeerbaum	Noun, common, masculine
bairan	tragen 	Verb
at-bairan	bringen	Verb
inn-atbairan	hineinbringen	Verb
fra-bairan	vertragen	Verb
ga-bairan	vergleichen	Verb
þairh-bairan	hindurchtragen	Verb
us-bairan	hinaustragen; hervorbringen; vorbringen d.i. antworten; ertragen	Verb
ūt-bairan	hinaustragen	Verb
Bairauja	Beroia in Thrakien	Noun, proper
bairgahei	Gebirgsgegend	Noun, common, feminine
bairgan	einen bergen, bewahren	Verb
ga-bairgan	einen bergen, bewahren	Verb
bairhtei	Helle	Noun, common, feminine
bairhtjan	offenbaren	Verb
ga-bairhtjan	offenbaren	Verb
bairhts	hell, offenbar	Adjective
bairhtaba	offen	Adverb, Comparative
baitrei	Bitterkeit	Noun, common, feminine
baitrs	bitter	Adjective
Baiþil	Baiþil	Noun, proper
[Baiþlaem]	[Baiþlaem]	<none>
Baiþsaïdan	Baiþsaïdan	<none>
bajoþs	beide	Numeral, other
balgs	Schlauch	Noun, common, masculine
†balsagga	Hals, Nacken	<none>
balsan	Salbe	Noun, common, neuter
balþaba	kühn, freimütig	Adverb
balþei	Kühnheit, Freimut	Noun, common, feminine
balþjan	kühn sein, wagen	Verb
balwawesei	Bosheit	Noun, common, feminine
balweins	Pein; Strafe; Folter	Noun, common, feminine
balwjan	martern	Verb
Banauis	Banauis	Noun, proper
bandi	Band, Fessel	Noun, common, feminine
bandja	Gefangener	Noun, common, masculine
bandwa	Zeichen	Noun, common, feminine
bandwjan	ein Zeichen, einen Wink geben, andeuten	Verb
ga-bandwjan	durch Winke andeuten	Verb
bandwo	Zeichen	Noun, common, feminine
banja*	Schlag, Wunde	Noun, common, feminine
bansts	Scheuer	Noun, common, masculine
Barabba(s)	Barabba	Noun, proper
Barakeias*	Barakeias*	Noun, proper
barbarus	Nicht	Noun, common, masculine
barizeins	von Gerste bereitet	Adjective
barms	Busen, Schoß	Noun, common, masculine
barn	Kind	Noun, common, neuter
Barnabas	Barnabas	Noun, proper
barnilo	Kindlein	Noun, common, neuter
barniskei	kindliches Wesen	Noun, common, feminine
barniski	Kindheit	Noun, common, neuter
barnisks	kindlich	Adjective
Barteimaiaus	Barteimaiaus	Noun, proper
Barþaulaumaius	Barþaulaumaius	Noun, proper
barusnjan	fromm verehren	Verb
Bassus*	Bassus*	Noun, proper
batiza	besser	Adjective
batista	batista	Adjective, Superlative
ga-batnan	Vorteil erlangen	Verb
Batwins*	Batwins*	Noun, proper
bauains	Wohnung	Noun, common, feminine
bauan	wohnen, bewohnen	Verb
ga-bauan	Wohnung aufschlagen	Verb
Bauanairgais	Bauanairgais	Noun, proper
Bauauz*	Bauauz*	Noun, proper
us-baugjan	ausfegen	Verb
uf-bauljan	aufblasen	Verb
baur	der Geborene	Noun, common, masculine
baurgja	Bürger	Noun, common, masculine
baurgs	Turm, Burg; Stadt	Noun, common, feminine
baurgswaddjus	Stadtmauer	Noun, common, feminine
baurþei	Bürde	Noun, common, feminine
bauþs	stumm	Adjective
beidan	auf etwas warten	Verb
ga-beidan	ausharren, ertragen	Verb
us-beidan	erwarten	Verb
beist	Sauerteig	Noun, common, neuter
ga-beistjan	durchsäuern	Verb
beitan	beißen	Verb
and-beitan	schelten, bedrohen	Verb
Beroþ	Beroþ	Noun, proper
berusjos	Eltern	Noun, common, masculine
Beþania	Beþania	Noun, proper
Beþlaihaim	Beþlaihaim	Noun, proper
Beþsaeida	Beþsaeida	Noun, proper
Beþsfagei	Beþsfagei	Noun, proper
bi	bei, um	Preposition, +AD
bibaurgeins	Lager	Noun, common, feminine
bida	Bitte, Gebet; Anliegen, Aufforderung	Noun, common, feminine
bidagwa	Bettler	Noun, common, masculine
bidjan	bitten, beten, betteln	Verb
ga-bidjan	beten, bitten	Verb
us-bidan	erbitten	Verb
bifaih	Übervorteilung	Noun, common, neuter
bifaihon	Übervorteilung	Noun, common
bihait	üble Nachrede	Noun, common, neuter
bihaitja	Prahler	Noun, common, masculine
biƕe	woran	Adverb
bijands	zugleich aber rüste auch	Participle, present
bimait	Beschneidung	Noun, common, neuter
bindan	einen mit etwas  binden	Verb
and-bindan	lösen; auflösen, erklären; entbinden von	Verb
bi-bindan	umbinden mit 	Verb
ga-bindan	binden	Verb
bireikei	Gefahr	Noun, common, feminine
birekjai	in Gefahr kommen	Noun, common
birodeins	Murren; Verleumdungen	Noun, common, feminine
birūnains	Nachstellung, Anschlag	Noun, common, feminine
birusjos	Eltern	<none>
bisauleins	Befleckung	Noun, common, feminine
bistug(g)q	Anstoß	Noun, common, neuter
bisunjane	ringsum	Adverb
biþe	nachher, später	Adverb
ana-biudan	entbieten, befehlen	Verb
faur-biudan	verbieten	Verb
biugan	beugen; sich beugen	Verb
ga-biugan	beugen	Verb
biuhti	Gewohnheit	Noun, common, neuter
biuhts	gewohnt	Adjective
biuþs*	Tisch	Noun, common, masculine
blandan	sich vermischen mit	Verb
blauþjan	abschaffen	Verb
ga-blauþjan	abschaffen	Verb
bleiþei	Wohlwollen, Güte	Noun, common, feminine
bleiþjan	barmherzig sein	Verb
ga-bleiþjan	sich erbarmen	Verb
bleiþs	barmherzig; dem Guten zugetan	Adjective
uf-blesan	aufblasen	Verb
bliggwan	schlagen	Verb
us-bliggwan	durchbleuen	Verb
ga-blindjan	verblenden	Verb
af-blindnan	erblinden	Verb
blinds	blind	Adjective
bloma*	Blume	Noun, common, masculine
blotan	verehren	Verb
blotinassus	Verehrung	Noun, common, masculine
bloþ	Blut	Noun, common, neuter
bloþarinnandei	blutflüssig	Participle, present
bnauan	reiben, zerreiben	Verb
boka	Buchstabe	Noun, common, feminine
bokareis	Schriftgelehrter; Schreiber	Noun, common, masculine
bota	Nutzen	Noun, common, feminine
botjan	nützen, bessern	Verb
ga-botjan	verbessern, herstellen	Verb
braƕa	im Augenblick	Noun, common
braidei	Breite	Noun, common, feminine
us-braidjan	ausbreiten nach	Verb
braiþs	breit	Adjective
brakja	Ringen, Ringkampf	Noun, common, feminine
ga-brannjan	verbrennen	Verb
in-brannjan	in Brand stecken	Verb
briggan	bringen	Verb
brikan	brechen; zerstören	Verb
ga-brikan	zerbrechen	Verb
uf-brikan	verwerfen, verachten	Verb
brinnan	brennen	Verb
uf-brinnan	verbrennen	Verb
brinno	Fieber	Noun, common, feminine
broþar	Bruder	Noun, common, masculine
broþrahans	Brüder	Noun, common, masculine
broþrulubo	Bruderliebe	Noun, common, feminine
brūkjan	gebrauchen	Verb
us-bruknan	ausgebrochen werden	Verb
brūks	brauchbar	Adjective
brunjo	Brustharnisch	Noun, common, feminine
brunna	Brunnen	Noun, common, masculine
brusts	Brust	Noun, common, feminine
brūþfaþs	Bräutigam	Noun, common, masculine
brūþs	Neuvermählte, Schwiegertochter	Noun, common, feminine
bugjan	kaufen	Verb
fra-bugjan	verkaufen für	Verb
us-bugjan	erkaufen	Verb
and-bundnan	entbunden werden	Verb
bwssaun	feines Linnen	Noun, common
ga-daban	was ihm bevorstand	Verb
daddjan	säugen	Verb
dags	Tag	Noun, common, masculine
daigs	Teig	Noun, common, masculine
Daikapaulis*	Daikapaulis*	Noun, proper
daila	Teilnahme, Gemeinschaft	Noun, common, feminine
dailjan	teilen, zuteilen, mitteilen	Verb
af-dailjan	abteilen, einen Teil abgeben 	Verb
dis-dailjan	verteilen, zerteilen	Verb
fra-dailjan	verteilen unter 	Verb
ga-dailjan	zuteilen, zerteilen	Verb
dails	Teil	Noun, common, feminine
daimonareis	Besessener	Noun, common, masculine
dals*	Grube; Schlucht, Tal	Noun, common, masculine
dalaþ	zu Tal, abwärts, nieder; auf die Erde	Adverb, directional
dalaþa	unten	Adverb, locative
dalaþro	von unten, unten	Adverb, directional
Dalmatia	Dalmatia	Noun, proper
Damaskon	Damaskon	Noun, proper
faur-dammjan	verdämmen, versperren	Verb
daubei	Taubheit	Noun, common, feminine
daubiþa	Taubheit	Noun, common, feminine
ga-daubjan	verstocken	Verb
af-daubnan	ertauben, verstockt werden	Verb
us-daudjan	sich beeifern	Verb
daufs	taub, verstockt	Adjective
dauhtar	Tochter	Noun, common, feminine
dauhts	Bewirtung	Noun, common, feminine
af-dauiþs*	geschunden, geplagt	<none>
dauns	Geruch	Noun, common, feminine
daupeins	Abwaschung	Noun, common, feminine
daupjan	taufen	Verb
uf-daupjan	taufen	Verb
daupjands	Täufer	Noun, common, masculine
daur	 Tor	Noun, common, neuter
daurawarda	Türhüterin	Noun, common, feminine
daurawardo	Türhüterin	Noun, common, feminine
daurawards	Türhüter	Noun, common, masculine
Dauriþaius*	Dauriþaius*	Noun, proper
daurons	 Tor, Tür	Noun, common, feminine
ga-daursan	sich erkühnen, wagen	Verb
dauþeins	das Absterben	Noun, common, feminine
dauþjan	töten	Verb
af-dauþjan	töten	Verb
ga-dauþjan	Tod bringen, töten	Verb
ga-dauþnan	sterben	Verb
miþ-gadauþnan	mit sterben	Verb
dauþs	tot	Adjective
dauþubleis*	zum Tode bestimmt	Adjective
dauþus	Tod	Noun, common, masculine
Daweid	Daweid	Noun, proper
Demas	Demas	Noun, proper
diabula	Verleumderin	Noun, common, feminine
diabaulus	Teufel	Noun, common, masculine
diabulus	diabulus	<none>
diakaunus	Diakon	Noun, common, masculine
Didimus	Didimus	Noun, proper
digan	kneten, aus Ton bilden	Verb
ga-digan	kneten, aus Ton bilden	Verb
digrei	Fülle	Noun, common, feminine
distaheins*	Zerstreuung	Noun, common, feminine
diswiss	Auflösung d.i. Abmarsch, das Scheiden	Noun, common, feminine
diupei	Tiefe	Noun, common, feminine
diupiþa	Tiefe	Noun, common, feminine
ga-diupjan	vertiefen	Verb
diups	tief	Adjective
dius*	wildes Tier	Noun, common, neuter
diwan	sterben	Verb
af-dobnan	af-dobnan	Verb
af-dojan*	geplagt	<none>
domjan	urteilen, beurteilen	Verb
af-domjan	beurteilen, verurteilen	Verb
bi-domjan	verurteilen	Verb
ga-domjan	urteilen, entscheiden	Verb
doms*	Ruhm	Noun, common, masculine
ga-draban	aushauen	Verb
†dragan	tragen	Verb
ga-dragan	zusammentragen	Verb
dragk	Trank	Noun, common, neuter
dragkjan	tränken mit	Verb
ga-dragkjan	tränken	Verb
draibjan	treiben; plagen	Verb
drakma*	Drachme	Noun, common, masculine
drauhsnos	Brocken; Brosamen	Noun, common, feminine
drauhtinassus	Feldzug	Noun, common, masculine
drauhtinon	Kriegsdienste tun, zu Felde ziehn	Verb
drauhtiwitoþ	Feldzug	Noun, common, neuter
af-drausjan	hinabstürzen	Verb
ga-drausjan	hinabstürzen	Verb
drausnos	Brocken; Brosamen	<none>
dreiban	treiben	Verb
us-dreiban	austreiben, vertreiben	Verb
drigkan	etwas trinken	Verb
ana-drigkan	sich antrinken, betrinken	Verb
ga-drigkan	trinken	Verb
driugan	zu Felde ziehen	Verb
driusan	fallen	Verb
at-driusan	fallen in	Verb
dis-driusan	einen  befallen	Verb
ga-driusan	hinfallen	Verb
us-driusan	herausfallen	Verb
driuso	Abhang	Noun, common, feminine
drobjan	trüben; irre machen; aufwiegeln	Verb
drobna	Aufruhr	Noun, common, masculine
drobnan	unruhig werden	Verb
ga-drobnan	in Bestürzung geraten	Verb
in-drobnan	in Bestürzung geraten	Verb
drugkanei	Trunkenheit	Noun, common, feminine
drunjus	Schall	Noun, common, masculine
drus	Fall	Noun, common, masculine
du	du	Adverb
dugan*	taugen	Verb
duƕe	wozu	Adverb
dulgahaitja	Gläubiger	Noun, common, masculine
dulgis	Schuld	Noun, common
dulþjan	ein Fest feiern	Verb
dulþs	Fest	Noun, common, feminine
af-dumbnan	verstummen	Verb
dumbs	stumm	Adjective
duþe	deshalb, deswegen, dazu	Unassigned
dwalawaurdei	Torenrede	Noun, common, feminine
dwaliþa	Torheit	Noun, common, feminine
dwalmon	rasen	Verb
dwals	töricht	Adjective
Eeiram	Eeiram	Noun, proper
ei	da	Particle
Eiaireiko	Eiaireiko	Noun, proper
Eikaunion	Eikaunion	Noun, proper
eisarn	Eisen	Noun, common, neuter
eisarnabandi	Eisenband, Kette	Noun, common, feminine
eisarneins	eisern	Adjective
eiþan	daher somit	Conjunction
†eiþau	†eiþau	Unassigned
Esaïas	Esaïas	Noun, proper
Esaw	Esaw	Noun, proper
fadar	Vater	Noun, common, masculine
[Faddasur]	[Faddasur]	Noun, proper
fadrein	Abkunft, Geschlecht, Stamm	Noun, common, neuter
fadreins	Geschlecht	Noun, common, feminine
faginon	sich freuen über	Verb
miþ-faginon	sich mitfreuen	Verb
fagrs*	geschickt, geeignet	Adjective
fāhan	fangen, greifen	Verb
ga-fahan	ergreifen, erfassen , ertappen	Verb
faheþs	Freude über	Noun, common, feminine
fulla-fahjan	Genüge leisten	Verb
ga-fahrjan	zubereiten	Verb
faian	tadeln	Verb
bi-faihon	übervorteilen	Verb
ga-faihon	übervorteilen	Verb
faihu	Vermögen	Noun, common, neuter
faihufrikei	Habsucht	Noun, common, feminine
faihufriks	habsüchtig, geldgierig	Adjective
faihugairnei	Habsucht	Noun, common, feminine
faihugairns	geldgierig	Adjective
faihugawaurki	Erwerb	Noun, common, neuter
faihugeiro	Habsucht	Noun, common, feminine
faihuskula	Schuldner	Noun, common, masculine
faihuþraihna	faihuþraihna	Noun, common
fairguni	Berg	Noun, common, neuter
wai-fairƕjan	wehklagen	Verb
fairƕus	Welt	Noun, common, masculine
fairina	Schuld; Grund; Vorwurf	Noun, common, feminine
fairinon	tadeln	Verb
fairneis*	alt	Adjective
fairniþa	Alter	Noun, common, feminine
fairns*	vorjährig	Adjective
fairra	fern	Adverb, locative
fairraþro	von fern	Adverb, directional
fairweitl	Schauspiel	Noun, common, neuter
fairzna	Ferse	Noun, common, feminine
Falaig	Falaig	Noun, proper
†Fallasur	†Fallasur	<none>
falþan	falten, zusammenrollen	Verb
fana	Stück Zeug	Noun, common, masculine
fani	Schlamm	Noun, common, neuter
Fanuel	Fanuel	Noun, proper
Farais*	Farais*	Noun, proper
faran	wandern, ziehen	Verb
Farao*	Farao*	Noun, proper
Fareisaius	Fareisaius	Noun, proper
farjan	fahren	Verb
at-farjan	einlaufen, landen	Verb
fāskja*	Binde	Noun, common
fastan	halten, festhalten; beobachten, bewachen	Verb
ga-fastan	behalten, bewahren	Verb
fastubni	das Halten, der Dienst	Noun, common, neuter
faþa	Zaun	Noun, common, feminine
fauho	Fuchs	Noun, common, feminine
faur	sie vorzulegen	Adverb
faura	vor	Adverb
fauradauri	Straße	Noun, common, neuter
faurafilli	Vorhaut	Noun, common, neuter
fauragagga*	Hausverwalter	Noun, common, masculine
fauragaggi	Verwaltung	Noun, common, neuter
fauragaggja	Verwalter	Noun, common, masculine
faurahāh	Vorhang	Noun, common, neuter
fauramaþleis	Vorsteher, Gebieter	Noun, common, masculine
fauramaþli	Oberbefehl	Noun, common, neuter
fauratani	Wunderzeichen	Noun, common, neuter
faurbauhts	Loskaufung, Erlösung	Noun, common, feminine
faurdomeins	Vorurteil	Noun, common, feminine
faurhāh	Vorhang	Noun, common, neuter
faurhtei	Furcht	Noun, common, feminine
faurhtjan	sich fürchten	Verb
faurhts	furchtsam	Adjective
faurlageins	Vorlegung	Noun, common, feminine
faurstasseis*	Vorsteher	Noun, common, masculine
Faurtunatus	Faurtunatus	Noun, proper
faurþis	zuvor, früher	Adverb
faurþizei	bevor	Conjunction
fawai*	wenige	Adjective
in-feinan	sich erbarmen	Verb
fera	Seite, Gegend	Noun, common, feminine
ferja*	Aufpasser	Noun, common, masculine
fetjan	schmücken	Verb
fian	hasse, verabscheuen	<none>
fidurdogs	viertägig	Adjective
fidurfalþs	vierfältig	Adjective
fidurragini	das Amt des Vierfürsten	Noun, common, neuter
fidwor	vier	Numeral, cardinal
fidwortaihun	vierzehn	Numeral, cardinal
figgragulþ	Fingerring	Noun, common, neuter
figgrs	Finger	Noun, common, masculine
fijan	hasse, verabscheuen	Verb
fijands	Feind	Noun, common, masculine
fijaþwa	Feindschaft	Noun, common, feminine
filaus	um vieles, viel	Adverb
filegri	Höhle	<none>
Filetus	Filetus	Noun, proper
filhan	verbergen	Verb
af-filhan	verbergen vor	Verb
ana-filhan	übergeben, überliefern; verpachten; empfehlen	Verb
ga-filhan	begraben	Verb
us-filhan	begraben	Verb
filigri*	Höhle	Noun, common, neuter
Filippai	Filippai	Noun, proper
Filippisius	Einwohner von Philippi	Noun, proper
Filippus	Filippus	Noun, proper
filleins	ledern	Adjective
filu	filu	Unassigned
filudeisei	Arglist	Noun, common, feminine
filufáihs	sehr bunt	Adjective
filugalaufs*	sehr wertvoll	Adjective
filusna	Vielheit, Menge; Übermaß	Noun, common, feminine
filuwaurdei	vieles Reden	Noun, common, feminine
filu-waurdjan	viel Worte machen	<none>
fimf	fünf	Numeral, cardinal
fimftaihun	fimftaihun	Numeral, cardinal
fimftataihunda	fünfzehnter	Numeral, ordinal
finþan	erkennen, erfahren	Verb
fiskja	Fischer	Noun, common, masculine
fiskon	fischen	Verb
fisks	Fisch	Noun, common, masculine
fitan	kreißen, gebären	Verb
flahtom	den Flechten	Noun, common
[us-flaugjan]	umgetrieben	Verb
flautjan	prahlen	Verb
flauts	von eitler Ruhmsucht, prahlerisch	Adjective
flodus	Strom, Flut	Noun, common
flokan*	betrauern	Verb
fodeins	Nahrung	Noun, common, feminine
fodjan	nähren, aufziehn	Verb
fodr	Scheide	Noun, common, neuter
fon	Feuer	Noun, common, neuter
fotubandi	Fußfessel	Noun, common, feminine
fotubaurd	Fußbank, Schemel	Noun, common, neuter
fotus	Fuß	Noun, common, masculine
frabauhtaboka	Verkaufsurkunde	Noun, common, feminine
fragan	fragen	Verb
fragifts	verlobt	Noun, common, feminine
fraihnan	fragen	Verb
ga-fraihnan	erfragen	Verb
fraisan	versuchen	Verb
us-fraisan	versuchen	Verb
fraistubni	Versuchung	Noun, common, feminine
fraiw	Same	Noun, common, neuter
fralet*	Erlaß	Noun, common, neuter
fralets	Freigelassener	Noun, common, masculine
fralusts	Verderben	Noun, common, feminine
fram	weiter	Adverb
framaldrs	im Alter vorgeschritten	Adjective
framaþeis*	fremd; einer Sache	Adjective
framaþjan	entfremden	Verb
framgāhts*	Fortschritt	Noun, common, feminine
framis	weiter	Adverb
framwairþis	fernerhin	Adverb
framwigis	fortwährend	Adverb
[fraqisteins]	Verderb, Vergeudung	Noun, common, feminine
frastisibja	Kindschaft	Noun, common, feminine
frasts	Kind	Noun, common
us-fratwjan	klug machen	Verb
fraþi	Verstand, Sinn	Noun, common, neuter
fraþjamarzeins	Verstandestäuschung	Noun, common, feminine
fraþjan	denken	Verb
fulla-fraþjan	bei  Verstand sein	Verb
frauja	Herr	Noun, common, masculine
fraujinassus	Herrschaft	Noun, common, masculine
fraujinon	herrschen über	Verb
ga-fraujinon	unterjochen	Verb
fraujinonds	Herrscher	Noun, common, masculine
frawardeins*	Verderben	Noun, common, feminine
frawaurhts	sündig	Adjective
frawaurhts	Sünde	Noun, common, feminine
fraweit	Strafe	Noun, common, neuter
freidjan	einen schonen	Verb
freihals	Freiheit	Noun, common, masculine
freis	frei von	Adjective
friaþwamildjai	zärtlich liebend	Adjective
frijaþwa	Liebe	Noun, common, feminine
frijei	Freiheit	Noun, common, feminine
frijon	lieben	Verb
frijondi	Freundin	Noun, common, feminine
frijonds	Freund	Noun, common, masculine
frijons	Kuß	Noun, common, feminine
ga-frisahtjan	abbilden	Verb
ga-frisahtnan	ein Abbild werden	Verb
frisahts	Bild	Noun, common, feminine
[Friþareikeis]	Friedrich	Noun, proper
ga-friþon	versöhnen mit	Verb
friusa	Frost	Noun, common
frodei	Klugheit, Verstand	Noun, common, feminine
froþs	klug, verständig	Adjective
fruma	fruma	Adjective, Comparative
frumabaur	Erstgeborener	Noun, common, masculine
frumadei	Vorrang	Noun, common, feminine
frumisti	Anfang	Noun, common, neuter
frumists	frumists	Adjective, Superlative
frumist	zuerst	Adverb, temporal
fugls	Vogel	Noun, common, masculine
fula	Füllen	Noun, common, masculine
fulgins	verborgen	Adjective
fulhsni	fulhsni	Noun, common, neuter
fulla-fahjan	P040.02	<none>
fulla-fraþjan	P040.03	<none>
fullatojis	vollkommen	Adjective
fullaweis	vollkommen 	Adjective
fulla-weisjan	überreden	<none>
fullawita	volkommen 	Noun, common, masculine
full[e]iþ	des Neumonds	Noun, common
fulljan	füllen	Verb
ga-fulljan	mit etw	Verb
ufar-fulljan	überfüllen	Verb
us-fulljan	erfüllen, vollenden, ersetzen	Verb
fullnan	voll werden von	Verb
ga-fullnan	erfüllt werden von	Verb
us-fullnan	erfüllt werden von	Verb
fullo	Fülle, Füllung ; Flicken	Noun, common, feminine
fulls	voll von	Adjective
fūls	faul	Adjective
funins, funin	Feuer	<none>
funisks	feurig	Adjective
Fwgailus	Fwgailus	Noun, proper
fwnikisks	phönikisch	Adjective
gaaggwei	Einschränkung	Noun, common, feminine
gaarbja	Miterbe	Noun, common, masculine
Gabaa	Gabaa	Noun, proper
Gabair	Gabair	Noun, proper
gabairhteins	Erscheinung	Noun, common, feminine
gabaur	Kollekte; Steuer	Noun, common, neuter
gabaur*	Festgelage	Noun, common, masculine
gabaurgja	Mitbürger	Noun, common, masculine
gabaurjaba	gern	Adverb
gabaurjoþus	Lust	Noun, common, masculine
gabaurþiwaurd	Geschlechtsregister	Noun, common, neuter
gabaurþs	Geburt	Noun, common, feminine
gabei	Reichtum	Noun, common, feminine
gabeigs	reich an	<none>
gabigjan	reich machen	Verb
gabignan	reich sein	Verb
gabigs	reich an	Adjective
gabigaba	reichlich	Adverb, Comparative
gabinda	Band	Noun, common, feminine
gabindi	Band	Noun, common, feminine
gableiþeins	Erbarmen	Noun, common, feminine
Gabriel	Gabriel	Noun, proper
gabruka	Brocken	Noun, common, feminine
gabundi	Band	Noun, common, feminine
gadaila	Teilnehmer, Genosse	Noun, common, masculine
gadauka*	Hausgenosse	Noun, common, masculine
Gaddarenus*	Gaddarenus*	Noun, proper
gadeþs*	Tat	Noun, common, feminine
[gadigis]	Gebilde	Noun, common, neuter
gadiliggs	Vetter	Noun, common, masculine
ga-dofs*	es schickt sich für	Adjective
gadrauhts	Soldat	Noun, common, masculine
gafāh*	Fang	Noun, common, neuter
gafaurds	Versammlung, hoher Rat	Noun, common, feminine
gafaurs	ehrbar; nüchtern, besonnen	Adjective
gafehaba	anständig	Adverb
gafeteins	Kleidung	Noun, common, feminine
gafilh*	Begräbnis	Noun, common, neuter
gafraþjei	Klugheit, Besonnenheit	Noun, common, feminine
gafreideins	Erhaltung, Bewahrung	Noun, common, feminine
gafrijons	Kuß	Noun, common, feminine
gafriþons	Versöhnung	Noun, common, feminine
gafulgins	verborgen vor	Adjective
gagg*	Weg, Straße	Noun, common, neuter
gaggan	gehen	Verb
af-gaggan	weggehn von	Verb
afar-gaggan	nachgehn, folgen	Verb
ana-gaggan	kommen	Verb
at-gaggan	hinzugehen, kommen	Verb
du-atgaggan	hinzukommen zu	Verb
inn-atgaggan	hineinkommen	Verb
faur-gaggan	vorübergehn	Verb
faur-bigaggan	einem vorausgehn	Verb
faura-gaggan	vorangehn	Verb
ga-gaggan	zusammenkommen	Verb
inn-gaggan	hineingehn	Verb
miþ-gaggan	mitgehn mit	Verb
þairh-gaggan	hindurchgehn, vorübergehn	Verb
ufar-gaggan	etw. übertreten	Verb
us-gaggan	ausgehn, hinausgehn	Verb
ūt-gaggan	hinausgehn, ausgehn	Verb
wiþra-gaggan	entgegengehn	Verb
gagrefts	Beschluß, Verordnung	Noun, common, feminine
gagudei	Frömmigkeit	Noun, common, feminine
gaguþs*	anständig, ehrbar	Adjective
gagudaba	fromm	Adverb, Comparative
gahāhjo	im Zusammenhang, der Reihe nach	Adverb
gahails	ganz unversehrt	Adjective
gahait	Verheißung	Noun, common, neuter
gahauseins	Gehör,  Predigt	Noun, common, feminine
gahlaiba	Genosse	Noun, common, masculine
gahlaifs*	Genosse	Adjective
[ga-hnipnan]	[ga-hnipnan]	Verb
gahobains	Enthaltsamkeit	Noun, common, feminine
gahraineins	Reinigung	Noun, common, feminine
gahugds	Gesinnung; Sinn; Gewissen	Noun, common, feminine
gaƕairbs	fügsam, getreu	Adjective
gaƕeilains	Verweilen, Ruhe	Noun, common, feminine
gaiainna	gaiainna	Noun, common
gaidw*	Mangel	Noun, common, neuter
gailjan	fröhlich machen	Verb
Gainnesaraiþ	Gainnesaraiþ	Noun, proper
gairda	Gürtel	Noun, common, feminine
bi-gairdan	umgürten	Verb
uf-gairdan	umgürten	Verb
Gairgaisainus*	Gairgaisainus*	Noun, proper
gairnei	Verlangen, Wunsch	Noun, common, feminine
gairnjan	begehren, verlangen nach; bedürfen	Verb
gairuni*	Leidenschaft	Noun, common, neuter
us-gaisjan	erschrecken	Verb
gaitein*	Böcklein	Noun, common, neuter
gaits	Ziege	Noun, common, feminine
Gaïus	Gaïus	Noun, proper
gajuk	 Paar	Noun, common, neuter
gajuka	Genosse	Noun, common, masculine
gajuko	 Gleichnis	Noun, common, feminine
gakunds	Überredung	Noun, common, feminine
gakunþs	gakunþs	Noun, common, feminine
gakusts	Probe	Noun, common, feminine
galaista	Nachfolger	Noun, common, masculine
Galateis	Galateis	Noun, proper
Galatia*	Galatia*	Noun, proper
galaubeins	gläubig	Adjective
galaubeins	Glaube	Noun, common, feminine
galaufs*	wertvoll	Adjective
galeika*	eines Leibes	Noun, common, masculine
galeiki*	Abbild	Noun, common, neuter
galeiks	ähnlich	Adjective
galeiko	gleich	Adverb, Comparative
Galeilaia	Galeilaia	Noun, proper
Galeilaius	Galeilaius	Noun, proper
galga	Pfahl, Kreuz	Noun, common, masculine
galigri	Beilager	Noun, common, neuter
galiug	Lüge	Noun, common, neuter
galiugaapaustaulus	falscher Apostel	Noun, common, masculine
galiugabroþar	falscher Bruder	Noun, common, masculine
galiugaguþ	Götze	Noun, common, neuter
galiugapraufetus*	falscher Prophet	Noun, common, masculine
galiugaweitwoþs	falscher Zeuge	Noun, common, masculine
galiugaxristus	falscher Christus	Noun, common, masculine
†galubaim	wertvoll	<none>
gamaindūþs	Gemeinschaft	Noun, common, feminine
gamainei	Gemeinschaft	Noun, common, feminine
gamainja	Teilnehmer	Noun, common, masculine
gamains	gemein	Adjective
gamainþs	Versammlung	Noun, common, feminine
gamaiþs*	verkrüppelt; verwundet	Adjective
gamalteins	Auflösung	Noun, common, feminine
gaman	Teilnehmer; Genosse	Noun, common, neuter
†gamarko	†gamarko	<none>
gamarzeins	Ärgernis	Noun, common, feminine
gamaudeins	Erinnerung	Noun, common, feminine
gameleins	Schrift; Buchstabenschrift	Noun, common, feminine
gaminþi	Gedächtnis, Erinnerung	Noun, common, neuter
gamitons	Gedanke	Noun, common, feminine
gamunds	Andenken, Gedächtnis	Noun, common, feminine
ganauha	Genüge, genügendes Auskommen; Genügsamkeit	Noun, common, masculine
ganists	Rettung, Heil	Noun, common, feminine
ganiþjis	Verwandter	Noun, common, masculine
ganohs	genug, viel	Adjective
gansjan	verursachen	Verb
gaqiss	übereinstimmend	Adjective
gaqiss	Verabredung	Noun, common, feminine
gaqumþs	Zusammenkunft, Versammlung; Vereinigung	Noun, common, feminine
garaideins	Anordnung, Satzung, Regel	Noun, common, feminine
garaihtei	Gerechtigkeit, Gebot	Noun, common, feminine
garaihteins	Zurechtweisung	Noun, common, feminine
garaihtiþa	Gerechtigkeit	Noun, common, feminine
garaihts	gerecht	Adjective
garaiþs*	angeordnet	Adjective
garazna	Nachbar	Noun, common, masculine
garazno	Nachbarin	Noun, common, feminine
garda	 Viehhof	Noun, common, masculine
gardawaldands	Hausherr	Noun, common, masculine
gards	Haus, Hauswesen, Familie	Noun, common, masculine
garedaba	anständig	Adverb
garehsns	bestimmte Zeit	Noun, common, feminine
gariudei	Schamhaftigkeit	Noun, common, feminine
gariudi	Ehrbarkeit	Noun, common, neuter
gariuþs*	ehrbar	Adjective
garūni	Beratung	Noun, common, neuter
garunjo	Flut	Noun, common, feminine
garuns	Markt; Straße	Noun, common, feminine
gasahts	Vorwurf	Noun, common, feminine
gasateins	Grundlegung	Noun, common, feminine
gasinþa*	Gefährte	Noun, common, masculine
gasinþja*	Gefährte	Noun, common, masculine
gaskadweins*	Bedeckung	Noun, common, feminine
gaskafts	Erschaffung	Noun, common, feminine
gaskaideins	Unterschied	Noun, common, feminine
gaskalki	Mitknecht	Noun, common, neuter
gaskohi	Sandalen, Schuhe	Noun, common, neuter
gaskohs	beschuht	Adjective
gastigodei	Gastfreundschaft	Noun, common, feminine
gastigoþs*	gastfrei	Adjective
gasts	Fremdling 	Noun, common, masculine
gataura	Riß	Noun, common, masculine
gataurþs*	Zerstörung	Noun, common, feminine
gatemiba	geziemend	Adverb
gatils	passend; geschickt zu	Adjective
gatilaba	zur rechten Zeit, passend	Adverb, Comparative
gatimreins	Erbauung	Noun, common, feminine
gatimrjo	Gebäude	Noun, common, feminine
gatwo	Gasse	Noun, common, feminine
gaþagki	Bedacht	Noun, common, neuter
gaþaurbs	enthaltsam	Adjective
gaþlaihts	Trost	Noun, common, feminine
gaþrafsteins	Trost	Noun, common, feminine
gaþrask	Tenne, Ausdrusch	Noun, common, neuter
gauja	Umgegend	Noun, common, masculine
Gaulgauþa	Gaulgauþa	Noun, proper
Gaumaurra	Gaumaurra	Noun, proper
Gaumaurjam	Gaumaurjam	Noun, proper
gaumjan	bemerken	Verb
gaunon	klagen; Totenklage anstimmen	Verb
[gaunoþus]	Klage	Noun, common, masculine
gaurei	Betrübnis	Noun, common, feminine
gauriþa	Betrübnis	Noun, common, feminine
gaurjan	einen kränken	Verb
gáurs	betrübt, traurig	Adjective
gawairþeigs	friedfertig	Adjective
gawairþi	Friede	Noun, common, neuter
gawaleins	Erwählung	Noun, common, feminine
gawamms	gemein d.i. unrein	Adjective
[gawandeins]	Bekehrung	Noun, common, feminine
gawargeins	Verurteilung	Noun, common, feminine
gawaseins	Bekleidung	Noun, common, feminine
gawaurdi	Gespräch	Noun, common, neuter
gawaurki	Geschäft; Erwerb; Gewinn	Noun, common, neuter
gawaurstwa	Mitarbeiter	Noun, common, masculine
[gawaurts]	eingewurzelt	Adjective
gawi	Gau	Noun, common, neuter
gawiljis*	einmütig	Adjective
gawiss	Verbindung, Band 	Noun, common, feminine
gawizneigs	voll Mitfreude	Adjective
gazaufwlakio	Schatzhaus	Noun, common
gazds	Stachel	Noun, common, masculine
faihu-geigan	begehren	Verb
ga-geigan	gewinnen	Verb
us-geisnan	sich entsetzen, erstaunen	Verb
giba	Gabe, Geschenk	Noun, common, feminine
giban	geben	Verb
gibands	Geber	Noun, common, masculine
af-giban sik	sich wegbegeben	Verb
at-giban	hingeben, übergeben	Verb
fra-giban	vergeben, verleihn, schenken	Verb
us-giban	erstatten, bezahlen	Verb
gibla	Giebel	Noun, common, masculine
gild	Steuer	Noun, common, neuter
fra-gildan	vergelten	Verb
us-gildan	vergelten	Verb
gilstr	Steuer	Noun, common, neuter
gilstrameleins	Eintragung in die Steuerliste	Noun, common, feminine
gilþa	Sichel	Noun, common, feminine
du-ginnan	beginnen	Verb
gistradagis	morgen	Adverb, temporal
bi-gitan	finden	Verb
giutan	gießen	Verb
ufar-giutan	übergießen d.i. übervoll gießen	Verb
glaggwaba	sorgsam	Adverb
glaggwo	genau	Adverb
glaggwuba	genau	Adverb
glitmunjan	glänzen	Verb
godakunds	von guter, edler Abkunft	Adjective
godei	Tugend	Noun, common, feminine
goleins	Gruß	Noun, common, feminine
goljan	grüßen	Verb
goþs	gut	Adjective
graba	Graben	Noun, common, feminine
graban	graben	Verb
bi-graban	mit einem Graben umgeben	Verb
uf-graban	nachgraben, unterwühlen	Verb
us-graban	ausgraben	Verb
gramjan	erzürnen	Verb
in-gramjan	erbittern	Verb
gramsta	Holzsplitter	Noun, common
gras	Gras, Kraut	Noun, common, neuter
gredags	hungrig	Adjective
gredon	hungern	Verb
gredus	Hunger	Noun, common, masculine
greipan	greifen	Verb
fair-greipan	ergreifen	Verb
und-greipan	ergreifen	Verb
gretan	weinen, klagen	Verb
grets	das Weinen	Noun, common, masculine
grindafraþjis*	kleinmütig	Adjective
griþs*	Schritt	Noun, common, feminine
groba	Grube, Höhle	Noun, common, feminine
grunduwaddjus	Grundmauer	Noun, common, masculine
gudafaurhts	gottesfürchtig	Adjective
gudalaus	gottlos	Adjective
gudaskaunei	Gottesgestalt	Noun, common, feminine
gudblostreis	Gottesverehrer	Noun, common, masculine
gudhūs	Gotteshaus	Noun, common, neuter
Gudilub	Gudilub	Noun, proper
gudisks	göttlich	Adjective
gudja	Priester	Noun, common, masculine
gudjinassus	Priestertum	Noun, common, masculine
gudjinon	Priester sein, des Priesteramts pflegen	Verb
gulþ	Gold	Noun, common, neuter
gulþeins	golden	Adjective
guma	Mann	Noun, common, masculine
gumakunds	männlichen Geschlechts	Adjective
gumein	Männchen	Noun, common, neuter
gund	Krebsgeschwür	Noun, common, neuter
us-gutnan	verschüttet werden	Verb
Gutþiuda	Gotenvolk	Noun, common, feminine
guþ	Gott	Noun, common, masculine
haban	haben, besitzen	Verb
af-haban	sich einer Sache enthalten	Verb
ana-haban	besitzen	Verb
at-haban	sich nähern	Verb
dis-haban	ergreifen	Verb
ga-haban	ergreifen	Verb
uf-haban	aufheben	Verb
hafjan	heben	Verb
and-hafjan	erwidern, antworten	Verb
at-hafjan	herabnehmen	Verb
ufar-hafjan	sich überheben	Verb
us-hafjan	erheben, wegnehmen	Verb
ufar-hafnan	sich überheben	Verb
haftjan	sich heften, hängen an	Verb
ga-haftjan	sich heften, hängen an	Verb
ga-gáhaftjan	zusammenheften, verbinden	Verb
ga-haftnan	anhangen	Verb
hafts	behaftet mit	Adjective
hāhan	hängen, in der Schwebe lassen	Verb
at-hahan	hinabhängen, hinablassen	Verb
us-hahan	sich erhängen	Verb
hāhan	hangen	Verb
Haibraius	Haibraius	Noun, proper
haidus	Art u. Weise	Noun, common, masculine
haifstjan	streiten	Verb
haifsts	Streit	Noun, common, feminine
háihs	einäugig	Adjective
Haileias*	Haileias*	<none>
Haileisaius	Haileisaius	Noun, proper
hailjan	einen  heilen	Verb
ga-hailjan	herstellen	Verb
ga-hailnan	hergestellt werden	Verb
hails	heil, gesund	Adjective
haimoþli	Grundbesitz	Noun, common, neuter
haims*	Stadt	Noun, common, feminine
hairaiseis	Parteien	Noun, common
hairda	Herde	Noun, common, feminine
hairdeis	Hirt	Noun, common, masculine
Hairmaugaineis	Hairmaugaineis	Noun, proper
Hairodia*	Hairodia*	<none>
hairto	Herz	Noun, common, neuter
hairþra	Eingeweide, Herz	Noun, common
hairus	Schwert	Noun, common, masculine
haizam	Fakkeln	Noun, common
haitan	heißen, nennen	Verb
ana-haitan	anrufen	Verb
and-haitan	einen, etw. bekennen; sich bekennen zu; etw. bekennen	Verb
at-haitan	herzurufen	Verb
fair-haitan	verheißen	Verb
ga-haitan	zusammenrufen	Verb
faura-gahaitan	zuvor verheißen	Verb
us-haitan	herausfordern	Verb
haiti	Geheiß	Noun, common, feminine
haiþi	Heide, Steppe	Noun, common, feminine
haiþiwisks	wild	Adjective
háiþno	Heidin	Noun, common, feminine
hakuls	Mantel	Noun, common, masculine
halba	Hälfte, Seite	Noun, common, feminine
halbs	halb	Adjective
haldan	hüten, weiden	Verb
haldis	mehr	Adverb
halisaiw	kaum je, kaum	Adverb
halja	Hölle	Noun, common, feminine
halks	leer, umsonst; dürftig, armselig	Adjective
hallus	Fels	Noun, common, masculine
hals	Hals	Noun, common, masculine
[halsagga]	Hals, Nacken	Noun, common, masculine
halts	lahm	Adjective
hamfs	verstümmelt	Adjective
af-hamon	die Bekleidung ablegen, ausziehn	Verb
ana-hamon	die Bekleidung anlegen, anziehn	Verb
and-hamon	sich einer Sache entkleiden	Verb
ga-hamon	sich bekleiden mit	Verb
ufar-hamon	überziehn, sich mit etwas überkleiden	Verb
hana	Hahn	Noun, common, masculine
handugei	Weisheit	Noun, common, feminine
handugs	weise, klug	Adjective
handus	Hand	Noun, common, feminine
handuwaurhts	mit der Hand gemacht	Adjective
hansa	Schar; Manipel; Kohorte	Noun, common, feminine
ga-hardjan	verhärten	Verb
harduhairtei	Hartherzigkeit	Noun, common, feminine
hardus	hart, streng	Adjective
harjis	Heer	Noun, common, masculine
hatan	hassen	Verb
hatis	Haß, Zorn	Noun, common, neuter
hatizon	zürnen	Verb
hatjan	hassen	Verb
haubiþ	Haupt	Noun, common, neuter
hauhei	Höhe	Noun, common, feminine
hauheins	Preis, Ehre	Noun, common, feminine
hauhhairtei	Hochmut	Noun, common, feminine
hauhhairts	hochmütig	Adjective
hauhisti*	höchste Höhe	Noun, common, neuter
hauhiþa	Höhe	Noun, common, feminine
hauhjan	hoch machen; preisen	Verb
ufar-hauhjan	verblenden	Verb
us-hauhjan	erhöhn	Verb
us-hauhnan	verherrlicht werden	Verb
háuhs	hoch	Adjective
hauhista	der Höchste 	Adjective, Superlative
hauhaba	hauhaba	Adverb
hauhis	höher	Adverb, Comparative
hauhþuhts	hochmütig, verblendet	Adjective
hauneins	Erniedrigung; Demut	Noun, common, feminine
hauniþa	Demut	Noun, common, feminine
haunjan	niedrig machen	Verb
ga-haunjan	erniedrigen	Verb
hauns	niedrig, demütig	Adjective
haurds	 Tür	Noun, common, feminine
hauri	Kohle	Noun, common, neuter
haurn	das hornförmig gebogene Johannisbrot	Noun, common, neuter
haurnja	Hornist	Noun, common, masculine
haurnjan	das Horn blasen	Verb
hauseins	Gehör d.i. Ohr	Noun, common, feminine
hausjan	hören	Verb
and-hausjan	gehorchen	Verb
ga-hausjan	das Gehör bekommen	Verb
uf-hausjan	gehorchen	Verb
hausjon	hören	Verb
hawi	Heu	Noun, common, neuter
hazeins	Lob, Loblied	Noun, common, feminine
hazjan	loben, preisen wegen	Verb
heito	Fieber	Noun, common, feminine
heiwafrauja	Hausherr	Noun, common, masculine
helei	helei	Foreign word
Helei*	Helei*	Noun, proper
Helias	Helias	Noun, proper
Her	Her	Noun, proper
her	hier, her	Adverb, locative
Herodes	Herodes	Noun, proper
Herodia	Herodia	Noun, proper
Herodianus*	Herodianus*	Noun, proper
heþjo	Kammer	Noun, common, feminine
hi-	dieser	Pronoun, demonstrative
hidre	hierher	Adverb, directional
hilms	Helm	Noun, common, masculine
hilpan	einem helfen	Verb
ga-hilpan	helfen	Verb
himinakunds	von himmlischer Abkunft	Adjective
himins	Himmel	Noun, common, masculine
himma, hina	dieser	<none>
hindana	hinter, jenseits	Unassigned
hindar	hinter, jenseits	Preposition, +AD
hindarweis	hinterlistig	Adjective
hindarweisei	Hinterlist	Noun, common, feminine
hindumists	der hinterste	Adjective, Superlative
fra-hinþan	gefangen nehmen	Verb
miþ-frahinþan	mitgefangen nehmen	Verb
us-hinþan	erbeuten	Verb
hiri	komm her, hierher	Unassigned
hita	dieser	<none>
hiufan	wehklagen, Klagelieder singen	Verb
hiuhma	Haufe, Menge	Noun, common, masculine
hiwi	Gestalt, Aussehn	Noun, common, neuter
hlahjan	lachen	Verb
bi-hlahjan	verlachen	Verb
hlaifs	Brot; Brotbissen	Noun, common, masculine
hlaine	Hügel	Noun, common
hlaiw	Grab	Noun, common, neuter
hlaiwasnos	Gräber	Noun, common, feminine
hlamma	Schlinge	Noun, common, feminine
hlas*	heiter	Adjective
hlasoza	sorgenfreier	Adjective, Comparative
hlasei	Heiterkeit	Noun, common, feminine
af-hlaþan	beladen	Verb
us-hlaupan	aufspringen, sich aufmachen	Verb
hlauts	Los; Anteil, Erbschaft	Noun, common, masculine
hleibjan	sich annehmen	Verb
hleiduma	link	Adjective, Comparative
hleiþra	Zelt, Hütte	Noun, common, feminine
ufar-hleiþrjan	ein Zelt über mir aufschlage	Verb
hleþrastakeins	das Zeltaufschlagen, Laubhüttenfest	Noun, common, feminine
hlifan	stehlen	Verb
hliftus	Dieb	Noun, common, masculine
hlijans	Hütten, Zelte	Noun, common
hliuma	Gehör	Noun, common, masculine
uf-hlohjan	auflachen machen	Verb
hlutrei	Lauterkeit	Noun, common, feminine
hlutriþa	Lauterkeit	Noun, common, feminine
hlūtrs*	lauter, rein	Adjective
hnaiweins	Erniedrigung, Demut	Noun, common, feminine
hnaiwjan	niedrig machen	Verb
ana-hnaiwjan	niederlegen	Verb
ga-hnaiwjan	erniedrigen	Verb
uf-hnaiwjan	einen unterwerfen unter 	Verb
hnaiws	niedrig, demütig	Adjective
hnasqjaim*	weich, weichlich	Adjective
hneiwan	sich neigen	Verb
ana-hneiwan	sich niederbeugen	Verb
[ga-hnipnan]	sich betrüben	Verb
dis-hniupan	zerreißen	Verb
dis-hnupnan	zerreißen	Verb
hnuþo	spitzer Pfahl	Noun, common, feminine
hoha	Pflug	Noun, common, masculine
holon	durch Betrug schädigen, schikanieren	Verb
af-holon	übervorteilen	Verb
horinassus	Ehebruch; Hurerei	Noun, common, masculine
horinon	huren, Ehebruch treiben	Verb
ga-horinon	Ehebruch begehn	Verb
hors	Hurer, Ehebrecher	Noun, common, masculine
hrainei	Reinheit, wohl auch Reinigung	Noun, common, feminine
hraineins	Reinigung	Noun, common, feminine
hrainjahairts	reinen Herzens	Adjective
hrainjan	reinigen	Verb
af-hrainjan	etwas Verunreinigendes tilgen	Verb
ga-hrainjan	reinigen	Verb
us-hrainjan	ausfegen	Verb
hrains	rein, ehrbar	Adjective
hraiwadūbo	Turteltaube	Noun, common, feminine
hramjan	kreuzigen	Verb
us-hramjan	kreuzigen	Verb
af-hrisjan	abschütteln	Verb
us-hrisjan	abschütteln	Verb
hropjan	rufen	Verb
uf-hropjan	aufschreien, ausrufen	Verb
hrops	Ruf, Geschrei	Noun, common, masculine
hrot	Dach, Haus	Noun, common, neuter
hroþeigs	siegreich	Adjective
hrugga	Stab	Noun, common, feminine
hrūkjan	krähen	Verb
hruk	das Krähen	Noun, common
and-hruskan	nachforschen	Verb
huggrjan	hungern	Verb
hugjan	denken, meinen	Verb
af-hugjan	bezaubern	Verb
†and-hugjan	†and-hugjan	Verb
faura-gahugjan	sich vornehmen	Verb
ufar-hugjan	sich überheben	Verb
hugs*	Verstand	Noun, common, masculine
hugs*	Landgut, Feld	Noun, common, neuter
huhjan	häufen, sammeln	Verb
huhrus	Hunger, Hungersnot	Noun, common, masculine
hulistr	Hülle	Noun, common, neuter
huljan	hüllen, verhüllen	Verb
and-huljan	enthüllen	Verb
dis-huljan	verhüllen	Verb
ga-huljan	verhüllen	Verb
us-hulon	aushöhlen	Verb
hulþs	hold	Adjective
hulundi	Höhle	Noun, common, feminine
-hun	-hun	Particle, enclitic
hunda	Hunderte	Numeral, cardinal
hundafaþs	Centurio	Noun, common, masculine
hunds	Hund	Noun, common, masculine
hunsl	Opfer	Noun, common, neuter
hunslastaþs	Opferstätte, Altar	Noun, common, masculine
hunsljan	opfern	Verb
hunþs*	Fang, Beute	Noun, common, masculine
hups	Hüfte	Noun, common, masculine
huzd	Hort, Schatz	Noun, common, neuter
huzdjan	Schätze sammeln	Verb
Hwmainaius	Hwmainaius	Noun, proper
hwssopon	hwssopon	Noun, common
ƕad	wohin	<none>
ƕadre	wohin	Adverb, directional
ƕa-h	jeder	<none>
ƕairban	wandeln	Verb
bi-ƕairban	umdrängen	Verb
ƕairnei*	Schädel	Noun, common, feminine
ƕaiteis*	Weizen	Noun, common, masculine
ƕaiwa	wie	Adverb
ƕan	wann	Adverb
ƕanhun	jemals	Adverb
af-ƕapjan	ersticken, auslöschen	Verb
af-ƕapnan	ersticken, erlöschen	Verb
ƕar	wo	Adverb
ƕarbon	wandeln	Verb
ƕarjis	wer	Pronoun, interrogative
ƕarjizuh	jeder	Pronoun, indefinite
ƕas	wer?	Pronoun, interrogative
ƕashun	jemand	Pronoun, indefinite
ƕassaba	scharf, streng	Adverb, manner
ƕassei	Schärfe, Strenge	Noun, common, feminine
[gaƕatjan]	[gaƕatjan]	Verb
ƕaþ	wohin	Adverb, directional
ƕaþar	wer von beiden	Pronoun, interrogative
[ƕaþaruh]	jeder von beiden	Pronoun, indefinite
ƕaþjan	schäumen	Verb
ƕaþo	Schaum	Noun, common, feminine
ƕaþro	woher	Adverb, directional
ƕazuh	jeder	Pronoun, indefinite
ƕe	wem, mit wem, womit	Adverb
ƕeh	jedenfalls, nur	Unassigned
ƕeila	Weile, Zeit, Stunde	Noun, common, feminine
ƕeilaƕairbs	nur eine Zeitlang dauernd, vergänglich	Adjective
ƕeilan	aufhören	Verb
ana-ƕeilan	beruhigen, erquicken	Verb
ga-ƕeilan	zur Ruhe kommen, aufhören	Verb
ƕeilohun	nicht eine Stunde lang	Unassigned
ga-ƕeitjan	weißen	Verb
ƕeits	weiß	Adjective
ƕelauþs*	wie groß	Adjective
ƕileiks	wie beschaffen?	Adjective
ƕilftrjom	Totenkiste, Sarg	Noun, common, feminine
ƕoftuli	Das Rühmen, der Ruhm	Noun, common, feminine
ƕoh	jeder	<none>
ƕopan	sich einer Sache rühmen	Verb
ƕota	Drohung	Noun, common, feminine
ƕotjan	drohen	Verb
ga-ƕotjan	einen bedrohn	Verb
Iaeirus	Iaeirus	Noun, proper
Iairaimias*	Iairaimias*	Noun, proper
Iairaupaulein	P064.10	Noun, proper
Iaireiko*, Iairiko*	Iericho	Noun, proper
Iairusalem	Iairusalem	Noun, proper
Iairusaulwma	Iairusaulwma	Noun, proper
Iairusaulwmeis	Iairusaulwmeis	Noun, common
Iairusaulwmeite	Iairusaulwmeite	Noun, proper
Iaissaizis	Iaissaizis	Noun, proper
Iakob	Iakob	Noun, proper
Iakobus	Iakobus	Noun, proper
Iaredis	Iaredis	Noun, proper
Iareim	Iareim	Noun, proper
Iasson	Iasson	Noun, proper
Iaurdanus*	Iaurdanus*	Noun, proper
ibai	doch nicht?	Particle
ibdaljin	Berglehne	Noun, common
ibna	gleich	Adjective
ibnaleiks	gleichen Körpers	Adjective
ibnaskauns*	gleichschön	Adjective
~skauneis*	~skauneis*	Adjective
ibnassus	Gleichheit	Noun, common, masculine
ga-ïbnjan	gleich machen	Verb
ibns	eben, flach	Adjective
ibuks	rückwärts gewandt	Adjective
iddja	iddja	<none>
idreiga	Buße	Noun, common, feminine
idreigon	Reue empfinden	Verb
ga-ïdreigon	bereuen, Buße tun	Verb
Idumaia	Idumaia	Noun, proper
idweit	Schmach, Schimpf	Noun, common, neuter
idweitjan	schmähn	<none>
Iesus	Iesus	Noun, proper
iftuma	am folgenden Tage	Adjective, Comparative
iggqar	euch beiden gehörig	Pronoun, possesive
igqis	igqis	Pronoun, personal
ik	ich	Pronoun, personal
ikei	der ich	Pronoun, personal, relative
in	in, auf, an, unter	Preposition, +ADG
inahei	Besonnenheit, Selbstbeherrschung	Noun, common, feminine
inahs	verständig	Adjective
ingardja	Hausgenosse	Noun, common, masculine
inilo	Entschuldigung	Noun, common, feminine
inkilþo	schwanger	Noun, common, feminine
inkunja*	Stammesgenosse, Landsmann	Noun, common, masculine
inmaideins	Vertauschung	Noun, common, feminine
inn	hinein	Adverb, directional
inna	innen, innerhalb	Adverb, locative
innakunds	zum Hause gehörig, Hausgenosse	Adjective
innana	von innen	Adverb, directional
innatgāhts*	Eingang, Eintritt	Noun, common, feminine
innaþro	von innen	Adverb, directional
inniujiþa	Erneuerung	Noun, common, feminine
innuma	der innere	Adjective, Comparative
insahts	Erzählung, Aussage, Zeugnis	Noun, common, feminine
inuh	ohne, außer	Preposition, +A
in-uh, in-uþ-	in, auf, an, unter	<none>
inwindiþa	Ungerechtigkeit	Noun, common, feminine
inwinds	ungerecht	Adjective
[inwitoþs]	innerhalb des Gesetzes stehend	Adjective
Ioanan	Ioanan	Noun, proper
Ioda	Ioda	Noun, proper
Iohanna	Iohanna	Noun, proper
Iohanna	Iohanna	Noun, proper
Iohannes	Iohannes	Noun, proper
Iora	Iora	Noun, proper
Ioreim	Ioreim	Noun, proper
Iosef	Iosef	Noun, proper
Iosezis	Iosezis	Noun, proper
is M, si F, ita N	er, der	Pronoun, personal
Isak	Isak	Noun, proper
Iskariotes	Iskariotes	Noun, proper
Israel	Israel	Noun, proper
Israeleites	Israeleites	Noun, proper
itan	essen	Verb
fra-ïtan	etw. verzehren, fressen	Verb
Ituraia	Ituraia	Noun, proper
iþ	aber	Conjunction
Iudaia	Iudaia	Noun, proper
Iudaialand	Iudaialand	Noun, common, neuter
Iudaius	Iudaius	Noun, proper
Judaius	Judaius	<none>
iudaiwisko	auf jüdische Weise	Adverb
iudaiwiskon	jüdisch leben	Verb
Iudas	Iudas	Noun, proper
iumjo	Haufe	Noun, common, feminine
iup	aufwärts	Adverb, directional
iupa	oben	Adverb, locative
iupana	von oben	Adverb
iupaþro	von oben her	Adverb, directional
Iuse	Iuse	<none>
iusila	Erholung	Noun, common, feminine
iusiza	vorzüglicher	Adjective, Comparative
izei	izei	Unassigned
ize	ize	<none>
izwar	euer	Pronoun, possesive
izwizei	der du	Pronoun, personal, relative
ja	ja	Unassigned
jabai	ob	Unassigned
Jaeirus	Jaeirus	<none>
jah	und, und zwar, auch	Unassigned
jai	ja, wahrlich, fürwahr	Unassigned
jainar	an jenem Ort, dort	Adverb, locative
jaind	dorthin	Adverb, directional
jaindre	dorthin	Adverb, directional
jaindwairþs	dorthin gewandt	Adjective
jains	jener	Pronoun, demonstrative
jainþro	dorther	Adverb, directional
Jairupulai	P072.07	Noun, proper
Janna	Janna	Noun, proper
Jannes	Jannes	Noun, proper
jaþþe	und wenn	Conjunction
jau	ob	Unassigned
Jaurdanau	Jaurdanau	<none>
jer	Jahr	Noun, common, neuter
jiuka	Zornausbrüche; Streitereien	Noun, common, feminine
jiukan	kämpfen; obsiegen	Verb
ga-jiukan	besiegen	Verb
Jiuleis	Julmonat	Unassigned
jota	jota	Noun, common, masculine
ju	schon	Adverb, temporal
judaiwisks	jüdisch	Adjective
Judaius	Judaius	<none>
Judas	Judas	<none>
juggs	jung; jugendlich	Adjective
juk	Gespann	Noun, common, neuter
jukuzi*	Joch	Noun, common, feminine
junda	Jugend	Noun, common, feminine
jūs	ihr	Pronoun, personal
Justus	Justus	Noun, proper
juþan	schon	Adverb
jūzei	jūzei	Pronoun, personal, relative
Kaballarja	Kaballarja	Noun, proper
Kaeinan	Kaeinan	Noun, proper
Kafarnaum	Kafarnaum	Noun, proper
Kaidmeiel	Kaidmeiel	Noun, proper
Kaidron	Kaidron	Noun, proper
kaisar*	Kaiser	Noun, common, masculine
kaisaragild	Census, Steuer	Noun, common, neuter
Kaisaria	Kaisaria	Noun, proper
Kajafa	Kajafa	Noun, proper
kalbo	Kalbe 	Noun, common, feminine
kalds	kalt	Adjective
kalkinassus	Hurerei	Noun, common, masculine
kalkjom	Hure	Noun, common, feminine
Kananeites*	Kananeites*	Noun, proper
kann	kennen, wissen	<none>
kannjan	einem  kund tun	Verb
ga-kannjan	verkünden	Verb
us-kannjan	verkünden	Verb
kapillon	das Haar abschneiden	Verb
kara	Sorge	Noun, common, feminine
[Kareiaþiareim]	[Kareiaþiareim]	Noun, proper
karkara	Kerker	Noun, common, feminine
karon	sich kümmern	Verb
ga-karon	besorgen	Verb
Karpus	Karpus	Noun, proper
kas	Gefäß	Noun, common, neuter
kasja	Töpfer	Noun, common, masculine
katile	Kessel	Noun, common, masculine
Kaulaussaium	den Kolossern	Noun, proper
kaupatjan	ohrfeigen	Verb
kaupon	Geschäfte machen, Handel treiben	Verb
Kaurazein	Kaurazein	Noun, proper
kaurban	Gabe, fromme Stiftung	Foreign word
[kaurbaunan]	Tempelschatz	Noun, common
kaurei*	Schwere, Fülle	Noun, common, feminine
Kaurinþius	Kaurinþius	Noun, proper
Kaurinþon	Kaurinþon	Noun, proper
kauriþa	Last	Noun, common, feminine
kaurjan	drücken, belästigen	Verb
ana-kaurjan	beschweren	Verb
miþ-kaurjan	mitbelastet mit	Verb
kaurjos	schwer, lästig	Adjective
kaurn	Getreide	Noun, common, neuter
kaurno	Korn	Noun, common, neuter
kausjan	kosten, kennen lernen	Verb
ga-kausjan	erproben	Verb
kawtsjo	kawtsjo	Foreign word
Kefas	Kefas	Noun, proper
keinan	keimen	Verb
us-keinan	hervorkeimen	Verb
miþ-uskeinan	mithervorkeimen	Verb
kelikn	Turm; Speisesaal im Obergeschoss	Noun, common, neuter
Kileikia*	Kileikia*	Noun, proper
kilþei	Mutterleib	Noun, common, feminine
kindins	Statthalter	Noun, common, masculine
kinnus	Wange	Noun, common, feminine
kintus	Heller	Noun, common, masculine
kiusan	etwas  prüfen	Verb
ga-kiusan	erproben	Verb
us-kiusan	erproben	Verb
Klemaintau	Klemaintau	Noun, proper
Klaimaintau	Klaimaintau	<none>
klismjan	gellen	Verb
klismo	Becken	Noun, common, feminine
kniu*	Knie	Noun, common, neuter
knodai	Geschlecht	Noun, common, feminine
knussjan	niederfallen	Verb
Kosam	Kosam	Noun, proper
Kreks	Grieche 	Noun, common, masculine
[Kreskus]	[Kreskus]	Noun, proper
Kretai	Kretai	Noun, proper
Kretes	Kretes	Noun, proper
Krispus	Krispus	Noun, proper
kriustan	knirschen	Verb
ga-kroton	zerbrechen, zerschellen	Verb
krusts	Knirschen	Noun, common
kubitus	Tischgesellschaft, Gruppe	Noun, common, masculine
kukjan	einen küssen	Verb
bi-kukjan	mit Küssen bedecken	Verb
ana-kumbjan	sich niederlegen, zu Tische legen	Verb
kumei	kumei	Foreign word
kunawida*	Fessel	Noun, common, feminine
kuni	Geschlecht, Stamm	Noun, common, neuter
kunnan	kennen, wissen	Verb
fra-kunnan	verachten	Verb
ga-kunnan	sich unterordnen, gehorchen	Verb
-kunnan	-kunnan	Verb
ana-kunnan	etw. lesen	Verb
at-kunnan	gewähren	Verb
ga-kunnan	kennen lernen, erfahren	Verb
uf-kunnan	erkennen	Verb
kunþi	Kunde, Kenntnis	Noun, common, neuter
kunþs	kund, bekannt	Adjective
Kusa	Kusa	Noun, proper
Kustanteinus	Kustanteinus	Noun, proper
kustus	Prüfung	Noun, common, masculine
Kwreinaius	Quirinius	Noun, proper
Kwreinaius	Einwohner von Kyrene	Noun, proper
laggamodei	Langmut	Noun, common, feminine
laggei	Länge	Noun, common, feminine
laggs	lang	Adjective
lagjan	legen, auflegen, hinlegen	Verb
af-lagjan	etwas ablegen	Verb
ana-lagjan	einem  auflegen	Verb
at-lagjan	hinlegen, auflegen	Verb
faur-lagjan	einem  etw. vorlegen	Verb
ga-lagjan	hinlegen	Verb
ufar-lagjan	überdecken	Verb
us-lagjan	us-lagjan	Verb
laian*	schmähn	Verb
lauan*	lauan*	<none>
laiba	Überbleibsel	Noun, common, feminine
bi-laibjan	übrig lassen	Verb
bilaif	bleiben	<none>
laigaion	Legion	Foreign word
bi-laigon	etw. belecken	Verb
laikan	hüpfen, springen	Verb
bi-laikan	einen  verspotten	Verb
laiks	Tanz	Noun, common, masculine
laiktjo	Leseabschnitt	Foreign word
lais	 weiß	Verb
laisareis	Lehrer	Noun, common, masculine
laiseigs	zum Lehren befähigt	Adjective
laiseins	Lehre	Noun, common, feminine
laisjan	lehren	Verb
ga-laisjan	lehren	Verb
us-laisjan	belehren	Verb
laistjan	einem folgen, nachstreben	Verb
afar-laistjan	einem nachfolgen, nachstreben; nachgehn 	Verb
ga-laistjan	Gastfreundschaft pflegend	Verb
laists	Spur	Noun, common, masculine
Laiwweis	Laiwweis	Noun, proper
Laiwweiteis	Laiwweiteis	Noun, common
Lamaik	Lamaik	Noun, proper
lamb	Lamm, Schaf	Noun, common, neuter
land	Land; Gegend	Noun, common, neuter
lasiws	schwach	Adjective
latei	Lässigkeit	Noun, common, feminine
latjan	aufhalten	Verb
ana-latjan	verhindern; ihr bekommt keine Gelegenheit	Verb
ga-latjan	verhindern	Verb
lats	lässig, faul	Adjective
laþaleiko	gern	Adverb
laþon	laden	Verb
at-laþon	berufen	Verb
ga-laþon	zusammenberufen, einladen	Verb
laþons	Einladung, Berufung	Noun, common, feminine
lauan*	schmähn	<none>
ga-laubjan	glauben	Verb
us-laubjan	einem erlauben	Verb
Laudeikaia*	Laudeikaia*	Noun, proper
laudi	Gestalt	Noun, common, feminine
laufs	Laub, Blatt	Noun, common, masculine
laugnjan	leugnen	Verb
ga-laugnjan	verborgen bleiben	Verb
lauhatjan	blitzen	Verb
lauhmuni*	Blitz	Noun, common, feminine
Lauidjai	Lauidjai	Noun, proper
laun	Lohn	Noun, common, neuter
launawargs*	undankbar	Adjective
laus	los, leer	Adjective
lausawaurdei	leeres Gerede	Noun, common, feminine
lausawaurdi	leeres Gerede	Noun, common, neuter
lausawaurds	hohle Schwätzer	Adjective
laushandja	mit leeren Händen	Adjective
lausjan	lösen	Verb
ga-lausjan	erlösen, befreien	Verb
us-lausjan	entwurzele dich	Verb
lausqiþrei	Fasten	Noun, common, feminine
lausqiþrs*	leeren Magens, nüchtern	Adjective
Lazarus	Lazarus	Noun, proper
bi-leiban*	bleiben	Verb
leihts	leicht	Adjective
leiƕan	leihen; sich borgen von	Verb
leik	Körper, Leib	Noun, common, neuter
leikains	Gefallen	Noun, common, feminine
leikan	einem gefallen, zu Gefallen sein	Verb
ga-leikan	gefallen	Verb
faura-galeikan	vorhergefallen	Verb
leikeins	leiblich, fleischlich	Adjective
leikeis, leikinassus, leikinon	Arzt	<none>
silda-leikjan, silda-leiknan	anstaunen, bewundern	<none>
gáleikon	meine Nachahmer	Verb
ga-gáleikon	sich verwandeln, eine Gestalt annehmen	Verb
in-gáleikon	verwandeln	Verb
miþ-gáleikon	mitnachahmen	Verb
þairh-gáleikon	þairh-gáleikon	Verb
lein	Leinwand	Noun, common, neuter
leitan	lassen	<none>
leitils	klein, wenig	Adjective
af-leiþan	weggehn, entweichen, verreisen	Verb
bi-leiþan	verlassen, zurücklassen	Verb
ga-leiþan	kommen, gehn	Verb
inn-galeiþan	hineingehn	Verb
miþ-inngaleiþan	mithineingehn	Verb
hindar-leiþan	hinzukommen	Verb
þairh-leiþan	hindurchgehn	Verb
ufar-leiþan	übersetzen	Verb
us-leiþan	hinausgehn, weggehn; verreisen	Verb
leiþu	Obstwein	Noun, common
lekeis	Arzt	Noun, common, masculine
lekinassus*	Heilung	Noun, common, masculine
lekinon	heilen	Verb
ga-leikinon	herstellen	Verb
letan	lassen	Verb
af-letan	entlassen	Verb
fra-letan	lassen; frei lassen, entlassen; unterlassen; zulassen, erlauben; erlassen, vergeben; herablassen	Verb
us-letan	ausschließen	Verb
and-letnan	scheiden	Verb
lew	Gelegenheit, Veranlassung	Noun, common
lewjan	verraten	Verb
fra-lewjan	verraten	Verb
ga-lewjan	hingeben, überlassen	Verb
libains	Leben	Noun, common, feminine
liban	leben	Verb
miþ-liban	mitleben	Verb
af-lifnan	übrig bleiben	Verb
ligan	liegen	Verb
at-ligan	steht in meiner Macht	Verb
uf-ligan	unterliegen	Verb
ligrs	Lager, Bett	Noun, common, masculine
lima	lima	Foreign word
af-linnan	weggehn	Verb
lisan	lesen, sammeln	Verb
ga-lisan	zusammenlesen, versammeln	Verb
listeigs	listig	Adjective
lists	List	Noun, common
litai	Heuchelei	Noun, common, feminine
liteins	Bittgebet	Noun, common, feminine
miþ-litjan	heucheln mit	Verb
liþus	Glied	Noun, common, masculine
liubaleiks	lieblich	Adjective
liudan	wachsen	Verb
awi-liudon	einem  danken	<none>
liufs*	lieb	Adjective
liuga	Heirat, Ehe	Noun, common, feminine
liugan	heiraten	Verb
ga-liugan	ein Weib nehmen	Verb
liugan	lügen	Verb
liugn	Lüge	Noun, common
liugnapraufetus*	Lügenprophet	Noun, common, masculine
liugnawaurds	Lügen redend	Adjective
liugnja	Lügner	Noun, common, masculine
liuhadei*	liuhadei*	Noun, common, feminine
liuhadeins	Helle, Glanz	Noun, common, feminine
liuhadeins*	hell	Adjective
liuhaþ	Licht	Noun, common, neuter
liuhtjan	leuchten	Verb
ga-liuhtjan	etw. erleuchten, ans Licht bringen	Verb
in-liuhtjan	erleuchten	Verb
fra-liusan	etwas verlieren	Verb
liutei	Heuchelei	Noun, common, feminine
liuts	Gaukler	Adjective
liuþareis	Sänger	Noun, common, masculine
liuþon	einem lobsingen	Verb
lofa*	flache Hand	Noun, common, masculine
Loþ*	Loþ*	Noun, proper
lubains	Hoffnung	Noun, common, feminine
lubjaleis	giftkundig	Adjective
lubjaleisei	Giftmischerei, Zauberei	Noun, common, feminine
ludja*	Angesicht	Noun, common, feminine
luftu	Luft	Noun, common
ga-lūkan	verschließen	Verb
us-lukan	erschließen, öffnen	Verb
lukarn	Leuchte, Licht	Noun, common, neuter
lukarnastaþa	Leuchter	Noun, common, masculine
Lukas	Lukas	Noun, proper
Lukius	Lukius	Noun, proper
ga-luknan	sich verschließen	Verb
us-luknan	sich erschließen, öffnen	Verb
lun	Lösegeld	Noun, common
fra-lusnan	verloren gehn	Verb
luston	begehren	Verb
lustus	Lust, Begierde	Noun, common, masculine
lustusama	ersehnt	Adjective
luton	taüschen	Verb
us-luton	verführen, irre führen	Verb
Lwddomaeis	Lwddomaeis	Noun, proper
Lwsanius*	Lwsanius*	Noun, proper
Lwstrws	Lwstrws	Noun, proper
Maeinan*	Maeinan*	Noun, proper
magan*	können, vermögen	Verb
ga-magan*	gelten, bedeuten	Verb
magaþei	Jungfrauschaft	Noun, common, feminine
magaþs*	Jungfrau	Noun, common, feminine
Magdalan	Magdalan	Noun, proper
Magdalene	Magdalene	Noun, proper
magula	Knäblein	Noun, common, masculine
magus	Knabe	Noun, common, masculine
Mahaþ*	Mahath	Noun, proper
mahteigs	mächtig; möglich	Adjective
ana-mahtjan	vergewaltigen; rauben; kränken, quälen; erpressen; mißhandeln	Verb
mahts	mahts	<none>
mahts	Macht, Kraft, Vermögen	Noun, common, feminine
maidjan	tauschen	Verb
in-maidjan	verwandeln	Verb
maihstus	Mist	Noun, common, masculine
Mailaian*	Mailaian*	Noun, proper
maile	Runzel	Noun, common
Mailkei*	Mailkei*	Noun, proper
maimbrana	Pergament	Noun, common, masculine
gámainjan	gemein machen	Verb
ga-gámainjan	verunreinigen	Verb
mais	mehr	Adverb, Comparative
Maisaullam*	Maisaullam*	Noun, proper
maists	der größte	Adverb, Superlative
maist	höchstens	Adverb, Comparative
maitan	etw. schneiden, hauen von	Verb
af-maitan	abhauen, abschneiden	Verb
bi-maitan	beschneiden	Verb
ga-maitan	zerschneiden, verschneiden	Verb
us-maitan	ausschneiden, abschneiden, ausrotten	Verb
maiþms	Geschenk	Noun, common
maiza	größer	Adjective, Comparative
Makeibis	Makeibis	Noun, proper
Makidoneis	Makidoneis	Noun, proper
Makidonja	Makidonja	Noun, proper
Makmas	Makmas	Noun, proper
malan	mahlen	Verb
[Malailaiel]	[Malailaiel]	Noun, proper
Malkus	Malkus	Noun, proper
malma	Sand	Noun, common, masculine
malo	Motte	Noun, common
ga-malwjan	zermalmen	Verb
Mambres	Mambres	Noun, proper
mammo	Fleisch	Noun, common, feminine
mammona*	mammona*	Noun, common
bi-mampjan	verhöhnen	Verb
man	meinen, glauben, dafür halten	<none>
managdūþs	Fülle	Noun, common, feminine
managei	Menge	Noun, common, feminine
managfalþs	mannigfaltig	Adjective
managjan	etw. mehren	Verb
managnan	reichlich vorhanden sein, Überfluß haben an	Verb
us-managnan	sich vermehren zu	Verb
manags	mancher, viel	Adjective
manamaurþrja	Menschenmörder	Noun, common, masculine
manaseþs	Welt, Menschheit	Noun, common, feminine
manaulja	der Gestalt nach	Noun, common
manleika	Bild	Noun, common, masculine
manna	manna	Noun, common
manna	Mensch, mann	Noun, common, masculine
mannahun	niemand	Pronoun, indefinite
manniskodus	Menschlichkeit	Noun, common, masculine
mannisks	menschlich	Adjective
manwiþa	Bereitschaft	Noun, common, feminine
manwjan	etw. bereitmachen, zurechtmachen	Verb
faura-manwjan	etw. vorbereiten	Verb
ga-manwjan	einem etw. bereiten zu	Verb
faura-gamanwjan	etw. vorher zubereiten	Verb
manwus	bereit	Adjective
maran aþa	der Herr kommt	Foreign word
marei	Meer	Noun, common, feminine
Maria	Maria	<none>
marikreitum	Perle	Noun, common
marisaiws*	See	Noun, common, masculine
Marja	Marja	Noun, proper
marka	Mark, Grenze	Noun, common, feminine
[Markaillaus]	Marcellus von Ancyra	Noun, proper
[ga-markon]	[ga-markon]	Verb
Markus	Markus	Noun, proper
†marwtre	Martyrer	Noun, common
Marþa	Marþa	Noun, proper
marzeins	Ärgernis	Noun, common, feminine
marzjan	einen ärgern, ihm zum Ärgernis sein	Verb
af-marzjan	Ärgernis nehmen	Verb
ga-marzjan	Ärgernis erregen	Verb
matibalgs	Ranzen, Speisesack	Noun, common, masculine
matjan	essen	Verb
ga-matjan	essen	Verb
mats	Speise	Noun, common, masculine
Mattaþanis	Mattaþanis	Noun, proper
Mattaþius*	Mattaþius*	Noun, proper
Matþaius*	Matþaius*	Noun, proper
Matþat	Matþat	Noun, proper
maþa	Wurm	Noun, common, masculine
maþl*	Versammlungsort, Marktplatz	Noun, common
maþlein	Rede, Redeweise	Noun, common, feminine
maþljan	reden	Verb
Maþusalis	Maþusalis	Noun, proper
maudjan	einen erinnern	Verb
ga-maudjan	einen erinnern an	Verb
maurgins	Morgen	Noun, common, masculine
ga-maurgjan	verkürzen	Verb
maurnan	sorgen für 	Verb
maurþr	Mord	Noun, common, neuter
maurþrjan	morden	Verb
mawi	Mädchen	Noun, common, feminine
mawilo	Mädchen	Noun, common, feminine
megs	Eidam	Noun, common, masculine
meins	mein	Pronoun, possesive
meki	Schwert	Noun, common
mel	Zeit, Stunde	Noun, common, neuter
mela	Scheffel	Noun, common, masculine
meljan	schreiben	Verb
ana-meljan	aufschreiben	Verb
faura-meljan	vorzeichnen, vormalen	Verb
ga-meljan	schreiben	Verb
faura-gameljan	vorher schreiben	Verb
uf-meljan	unterschreiben	Verb
ufar-meljan	etw. überschreiben	Verb
mena	Mond	Noun, common, masculine
menoþs	Monat	Noun, common, masculine
mereins	Verkündigung, Predigt	Noun, common, feminine
Merila	Merila	Noun, proper
meriþa	Gerücht, Kunde	Noun, common, feminine
merjan	etw. künden, kund tun	Verb
merjands	Verkündiger, Prediger	Noun, common, masculine
us-merjan	verkünden	Verb
wailamerjan	einem eine frohe Botschaft künden	Verb
wajamerjan	lästern	Verb
us-mernan	sich  verbreiten	Verb
mes	Tisch; Schüssel, Platte; Kelter	Noun, common, neuter
midgardiwaddjus	Zwischenwand	Noun, common
midjasweipains	Überflutung, Sintflut	Noun, common, feminine
midjis*	midjis*	Adjective
midjungards	die bewohnte Erde, der Erdkreis	Noun, common, masculine
miduma*	Mitte	Noun, common, feminine
midumonds	Mittler	Noun, common, masculine
mikildūþs	Größe	Noun, common, feminine
mikilei	Größe	Noun, common, feminine
mikiljan	preisen	Verb
ga-mikiljan	preisen	Verb
mikilnan	verherrlicht werden	Verb
mikils	groß	Adjective
mikilþuhts	hochmütig	Adjective
mildiþa	Milde	Noun, common, feminine
milhma	Wolke	Noun, common, masculine
militon	die Soldaten	Verb
miliþ	Honig	Noun, common, neuter
miluks*	Milch	Noun, common, feminine
mimz	mimz	Noun, common
minnists	der kleinste, geringste	Adjective, Superlative
minniza	kleiner, geringer	Adjective, Comparative
mins	minder, weniger	Adverb, Comparative
minznan	abnehmen	Verb
missadeþs*	Missetat	Noun, common, feminine
missaleiks	verschieden	Adjective
missaqiss	Zwiespalt, Mißrede	Noun, common, feminine
missataujands	Übeltäter	<none>
misso	einander	Adverb
mitadjo	Maß	Noun, common, feminine
mitan	messen	Verb
ga-mitan	zumessen	Verb
us-mitan	wandeln, sich benehmen, leben	Verb
mitaþs	Maß	Noun, common, feminine
miton	ermessen, denken, überlegen	Verb
ufar-miton	vergessen	Verb
mitons	Überlegung, Gedanke	Noun, common, feminine
miþ	mit, bei, unter	Preposition, +D
miþgardawaddjus	Zwischenwand	<none>
miþþan	inzwischen	Adverb
miþþanei	während	Conjunction
miþwissei	Bewußtsein, Gewissen	Noun, common, feminine
mizdo	Lohn	Noun, common, feminine
modags	zornig auf 	Adjective
af-mojan*	ermüdet	<none>
Moses	Moses	Noun, proper
mota	Zoll	Noun, common, feminine
ga-motan*	Raum finden	Verb
motareis	Zöllner	Noun, common, masculine
motastaþs	Zollstätte	Noun, common, masculine
ga-motjan	einem begegnen	Verb
wiþra-gamotjan	einem begegnen	Verb
moþs*	Zorn	Noun, common, masculine
mukamodei*	Nachgiebigkeit, Sanftmut	Noun, common, feminine
mulda	Staub	Noun, common, feminine
muldeins	von Staub, irdisch	Adjective
faur-mūljan	einem das Maul verbinden	Verb
munan	meinen, glauben, dafür halten	Verb
ga-munan	sich einer Sache	Verb
munan	etw. zu tun gedenken, wollen	Verb
mundon	einen besehn, sehen auf	Verb
mundrei*	Ziel	Noun, common, feminine
ufar-munnon	vergessen	Verb
muns	Gedanke, Meinung	Noun, common, masculine
munþs	Mund	Noun, common, masculine
Nabaw*	Nabaw*	Noun, proper
nadre	Natter	Noun, common
[Naem]	[Naem]	Noun, proper
Naggai*	Naggai*	Noun, proper
ga-nagljan	festnageln an	Verb
bi-nah	es ist erlaubt, nötig	Verb
ga-nah	es genügt einem	Verb
Nahasson	Nahasson	Noun, proper
nahtamats	, Abendessen, Abendmahl, Gastmahl	Noun, common, masculine
nahts	Nacht	Noun, common, feminine
Naiman	Naiman	Noun, proper
naiteins	Lästerung	Noun, common, feminine
ga-naitjan	beschimpfen	Verb
Naitofaþeis	Naitofaþeis	Noun, proper
Nakor	Nakor	Noun, proper
namnjan	nennen	Verb
ga-namnjan	benennen	Verb
namo	Name	Noun, common, neuter
ana-nanþjan	Mut fassen, sich erkühnen	Verb
†ga-nanþjan	aufhören	Verb
naqadei	Nacktheit	Noun, common, feminine
naqaþs	nackt	Adjective
nardus	Narde	Noun, common, masculine
naseins	Rettung, Heil	Noun, common, feminine
nasjan	retten	Verb
nasjands	Heiland	Noun, common, masculine
ga-nasjan	erretten, herstellen	Verb
nati	Netz	Noun, common, neuter
natjan	netzen	Verb
ga-natjan	benetzen	Verb
Naþan	Naþan	Noun, proper
Naubaimbair	November	Foreign word
naudibandi	Kette, Handschellen	Noun, common, feminine
naudiþaurfts	notwendig	Adjective
naudiþaurfts	Notwendigkeit	Noun, common, feminine
Nauel	Nauel	Noun, proper
nauh	noch	Adverb
nauhþan	noch	Unassigned
nauhþanuh	noch	Unassigned
nauhuþþan	und sogar noch	Unassigned
Naum	Naum	Noun, proper
naus	der Tote	Noun, common, masculine
nauþjan	nötigen	Verb
ana-nauþjan	durch Zwang veranlassen	Verb
nauþs	Not, Zwang	Noun, common, feminine
nawis	tot	Adjective
ga-nawistron	begraben	Verb
miþ-ganawistron	einen mit jemand  begraben	Verb
Nazaraiþ	Nazaraiþ	Noun, proper
Nazoraius	Nazoräer, Nazarener	Noun, proper
Nazorenus*	Nazoräer, Nazarener	Noun, proper
ne	nein	Unassigned
neƕ	nahe	Adverb
neƕis	näher	Adverb, Comparative
neƕa	nahe	Adverb, locative
neƕjan	sich einem nähern	Verb
at-neƕjan	herannahen	Verb
neƕundja	der Nächste	Noun, common, masculine
nei	nicht	Unassigned
neiþ	Neid	Noun, common, neuter
Ne(i)kaudemus	Nekaudemus	<none>
neiwan*	es auf jemand abgesehn haben	Verb
Nerins	Nerins	Noun, proper
neþla	Nadel	Noun, common, feminine
ni	nicht	Unassigned
nibai, niba	doch nicht etwa?	Unassigned
nidwa	das Verzehren, der Rost	Noun, common
nih	und nicht, auch nicht, nicht	Unassigned
Nikaudemus	Nikaudemus	Noun, proper
niman	nehmen, annehmen, aufnehmen, empfangen, fangen	Verb
af-niman	abnehmen, wegnehmen	Verb
and-niman	annehmen, aufnehmen, empfangen	Verb
at-niman	aufnehmen; wohin versetzen	Verb
bi-niman	wegnehmen	Verb
dis-niman	besitzen	Verb
fra-niman	nehmen	Verb
ga-niman	mitnehmen	Verb
in-niman	hernehmen	Verb
miþ-niman	annehmen, gelten lassen	Verb
us-niman	herausnehmen, wegnehmen	Verb
ga-nisan	genesen, errettet werden	Verb
nist	nist	Unassigned
niþan	helfen	Verb
niþjis	Verwandter	Noun, common, masculine
niþjo	die Verwandte	Noun, common, feminine
niu	nicht	Unassigned
niuhseins	Heimsuchung	Noun, common, feminine
bi-niuhsjan	auskundschaften, ausspionieren	Verb
ana-niujan	erneuern	Verb
niujasatiþs*	 der Neubekehrte, der Neuling	Participle, past
niujis	neu	Adjective
niujiþa	Neuheit	Noun, common, feminine
niuklahei	Unverstand	Noun, common, feminine
niuklahs	unmündig, kindisch	Adjective
niun	neun	Numeral, cardinal
niunda	der neunte	Numeral, ordinal
niuntehund	neunzig	Numeral, cardinal
niutan	treffen, erreichen; einer Sache froh sein	Verb
ga-niutan	ergreifen, erwischen	Verb
ga-nohjan	die er uns reichlich gewährte	Verb
ga-nohnan	zur Genüge versehn sein mit 	Verb
notin	auf dem Achterdeck	Noun, common
nu	nun, jetzt	Adverb
nuh	denn	Unassigned
nunu	demnach, daher	Unassigned
nuta	Fänger, Fischer	Noun, common, masculine
Nwmfan	Nwmfan	Noun, proper
o	ach, pfui	Interjection
Obeid*	Obeid*	Noun, proper
Odueia*	Odueia*	Noun, proper
ogan*	sich fürchten vor 	Verb
ogjan	einen schrecken	Verb
ohteigo	Zeit habend	<none>
Osaiin	Osaiin	Noun, proper
osanna	osanna	Foreign word
paida	Leibrock, Unterkleid	Noun, common, feminine
ga-paidon	 bekleiden	Verb
paintekuste*	paintekuste*	Noun, common
Paitrus	Paitrus	Noun, proper
papan	Presbyter, Geistlicher	Noun, common
parakletus	Tröster	Noun, common, masculine
paraskaiwe	Rüsttag	Noun, common
paska	paska	Noun, common
pasxa	pasxa	<none>
Pauntius*	Pauntius*	Noun, proper
paurpura	Purpur	Noun, common
paurpaura	paurpaura	<none>
paurpuroþs	purpurn	Adjective
Pawlus	Pawlus	Noun, proper
peikabagms	Palmbaum	Noun, common, masculine
Peilatus	Peilatus	Noun, proper
[pistikeins]	unverfälschte o. flüssige Narde	Adjective
plapja	Straße	Noun, common, feminine
plat	Flicken	Noun, common
plinsjan	tanzen	Verb
ana-praggan	bedrängen	Verb
praitoriaun	praitoriaun	Noun, common
praizbwtairei	christlich. Gemeindebehörde	Noun, common, feminine
praizbwtairi*	praizbwtairi*	Noun, common, neuter
praufeteis	Prophetin	Noun, common, feminine
praufetes	Prophet	Noun, common
praufetja	Weissagung	Noun, common
praufetjan	weissagen	Verb
Priska	Priska	Noun, proper
psalmon	Psalm	Noun, common
pugg	Geldbeutel	Noun, common
pund	Pfund	Noun, common
qainon	weinen, trauern	Verb
qairrei	Sanftmut	Noun, common, feminine
qairrus	sanft, freundlich gegen	Adjective
qairu	Pfahl, Stachel	Noun, common, neuter
Qartus	Quartus	Noun, proper
qens	Eheweib	Noun, common, feminine
qiman	kommen	Verb
ana-qiman	hinzutreten	Verb
bi-qiman	einen überfallen	Verb
faura-qiman	vor jemand hergehn	Verb
fra-qiman	etw. verzehren, ausgeben, vertun	Verb
ga-qiman	zusammenkommen	Verb
miþ-qiman	mitkommen mit	Verb
us-qiman	umbringen, den Tod geben	Verb
qinakunds	weiblichen Geschlechts	Adjective
qineins	Frauenzimmer, Weibsleute	Adjective
qino	femina, Weib	Noun, common, feminine
qisteins	Verderben	Noun, common, feminine
qistjan	verderben	Verb
fra-qistjan	verderben, umbringen	Verb
us-qistjan	verderben, umbringen	Verb
fra-qistnan	umkommen, zugrunde gehn	Verb
qiþan	sagen	Verb
af-qiþan	verzichten auf	Verb
ana-qiþan	verleumden, verlästern	Verb
and-qiþan	Abschied nehmen 	Verb
faur-qiþan	sich entschuldigen	Verb
faura-qiþan	vorhersagen	Verb
fra-qiþan	für ungültig erklären, aufheben	Verb
ga-qiþan	sich verabreden, übereinkommen, beschließen	Verb
miþ-qiþan	mitsprechen, nachsprechen	Verb
us-qiþan	ein Gerede verbreiten	Verb
qiþuhafto	die Schwangere	Noun, common, feminine
qiþus	Magen; Mutterschoß	Noun, common, masculine
ana-qiujan	beleben	Verb
ga-qiujan	beleben	Verb
miþ-gaqiujan	mitbeleben	Verb
ga-qiunan	aufleben	Verb
qius*	lebendig	Adjective
†qrammiþa	Feuchtigkeit	Noun, common, feminine
qums	das Kommen; Gegenwart, Ankunft, Wiederkunft Christi	Noun, common, masculine
rabbaunei	rabbaunei	Foreign word
rabbei	rabbei	Foreign word
Ragaw*	Ragaw*	Noun, proper
ragin	Rat, Beschluß	Noun, common, neuter
ragineis	Ratgeber, Ratsherr	Noun, common, masculine
raginon	etw. verwalten	Verb
ga-raginon	einen Rat geben	Verb
rahnjan	rechnen	Verb
faura-rahnjan	einen übertreffen an	Verb
ga-rahnjan	abschätzen	Verb
rahton	darreichen	Verb
Raibaikka	Raibaikka	Noun, proper
raidjan	verordnen	Verb
ga-raidjan	befehlen, verordnen, bestimmen	Verb
raihtis	nämlich, doch, etwa	Conjunction
gáraihtjan	als gerecht erweisen	Verb
at-gáraihtjan	vollends in Ordnung bringen	Verb
raihts	recht, grade	Adjective
raihtaba	recht, richtig	Adverb, Comparative
ur-raisjan	zum Aufstehn bringen, aufrichten, erwecken	Verb
raka	raka	Foreign word
uf-rakjan	aufrecken	Verb
Rama	Rama	Noun, proper
ur-rannjan	aufgehn lassen	Verb
rasta	Meile	Noun, common, feminine
ga-raþjan	zählen	Verb
raþjo	Abrechnung, Konto; Zahl	Noun, common, feminine
raþizo	leichter	Adjective, Comparative
bi-raubon	einen berauben	Verb
in-rauhtjan	erzürnt werden	Verb
raupjan	raufen	Verb
raus	Rohr	Noun, common, neuter
rauþs*	rot	Adjective
razda	Sprache, Sprechweise	Noun, common, feminine
razn	Haus	Noun, common, neuter
ga-redan	Vorsorge treffen für	Verb
faura-garedan	einen vorherbestimmen zu	Verb
und-redan	besorgen, gewähren	Verb
ur-redan	warum lasset ihr euch Satzungen auflegen, als lebtet ihr in der Welt	Verb
reiki	Reich, Herrschaft, Obrigkeit	Noun, common, neuter
reikinon	herrschen über	Verb
reikeis*	reikeis*	Adjective
reiks*	reiks*	Adjective
reiks	Herrscher, Obrigkeit	Noun, common, masculine
reiran	zittern	Verb
in-reiran	erzittern, erbeben	Verb
reiro	das Zittern	Noun, common, feminine
ur-reisan	erstehn, sich erheben	Verb
Resa*	Resa*	Noun, proper
rign	Regen	Noun, common, neuter
rignjan	regnen	Verb
rikan	häufen	Verb
rimis*	Ruhe	Noun, common, neuter
rinnan	rennen, laufen	Verb
and-rinnan	streiten	Verb
at-rinnan	hinzulaufen	Verb
du-atrinnan	hinzulaufen	Verb
bi-rinnan	einen umringen	Verb
du-rinnan	hinzulaufen	Verb
fair-rinnan	sich erstrecken, reichen zu	Verb
faur-rinnan	vorhergehn	Verb
fra-rinnan	sich verlaufen zu, geraten unter	Verb
ga-rinnan	zusammenlaufen, zusammenkommen	Verb
und-rinnan	zufallen, zuteil werden	Verb
ur-rinnan	auslaufen, ausgehn	Verb
rinno	Gießbach	Noun, common, feminine
riqis	Finsternis	Noun, common, neuter
riqizeins	finster	Adjective
riqizjan	finster werden	Verb
riurei	Vernichtung, vom ewigen Tod gesagt	Noun, common, feminine
riurjan	verderben	Verb
riureis*	vergänglich, sterblich	Adjective
riurs*	riurs*	Adjective
rodjan	sprechen, reden	Verb
bi-rodjan	murrend reden, murren	Verb
miþ-rodjan	mit einem reden	Verb
rohsns	Hof	Noun, common, feminine
Rufus	Rufus	Noun, proper
rūmis	Raum	Noun, common
Rūma*	Rūma*	Noun, proper
ur-rūmnan	sich erweitern	Verb
Rūmoneis*	Rūmoneis*	Noun, proper
rūms	geräumig	Adjective
rūna	Geheimnis	Noun, common, feminine
runs	Lauf	Noun, common, masculine
sa	der, dieser	Pronoun, demonstrative
Sabaillius	Sabellius	Noun, proper
saban*	feine Leinwand	Noun, common
Sabaoþ	Sabaoþ	Noun, proper
sabbato	sabbato	Noun, common, masculine
Saddukaieis	Saddukaieis	Noun, proper
sads	satt	<none>
saei	der	Pronoun, relative
saggqjan	senken	Verb
uf-saggqjan	versenken	Verb
uf-saggqjan	uf-saggqjan	<none>
saggqa	Untergang, Westen	Noun, common
saggws	Vorlesung, Rezitation	Noun, common, masculine
sah	der u. kein andrer, eben der	Pronoun, demonstrative
saƕazuh	was auch immer	Pronoun, indefinite
sai	ecce, sieh	Adverb
saian	säen	Verb
in-saian	einsäen	Verb
saihs	sechs	Numeral, cardinal
saihsta	der sechste	Numeral, ordinal
saiƕan	sehn	Verb
and-saiƕan	auf etw. sehn, es berücksichtigen	Verb
at-saiƕan	auf etw. sehn, acht geben	Verb
bi-saiƕan	umsehn	Verb
ga-saiƕan	erblicken	Verb
in-saiƕan	hinsehn; auf etw. sehn, nach etw. sehn	Verb
þairh-saiƕan	dúrchschauen	Verb
us-saiƕan	aufblicken	Verb
in-sailjan	anseilen	Verb
Sailaum	Sailaum	Noun, proper
Saimaiein	Saimaiein	Noun, proper
sainjan	zögern, säumen	Verb
sáir	Schmerz	Noun, common, neuter
Sairok	Sairok	Noun, proper
saiwala	Seele	Noun, common, feminine
saiws	See	Noun, common, masculine
Saixaineia	Saixaineia	Noun, proper
sakan	streiten	Verb
and-sakan	widersprechen, bekämpfen	Verb
ga-sakan	schelten	Verb
in-sakan	vorstellen, anraten; eintreten für; bezeichnen	Verb
ana-insakan	ana-insakan	Verb
us-sakan	erörtern, vorlegen	Verb
sakjo	Streit	Noun, common, feminine
sakkus	Sack	Noun, common, masculine
sakuls	streitsüchtig	Adjective
Salamis	Salamis	Noun, proper
Salaþiel	Salaþiel	Noun, proper
salbon	salben	Verb
ga-salbon	salben	Verb
salbons	Salbe	Noun, common, feminine
saldra	leichtfertiges Geschwätz	Noun, common, feminine
saliþwos	Herberge	Noun, common, feminine
saljan	opfern	Verb
and-saljan	darbringen	Verb
ga-saljan	zum Opfer bringen	Verb
saljan	herbergen, bleiben	Verb
us-saljan	Herberge nehmen	Verb
Salmon	Salmon	Noun, proper
Salome	Salome	Noun, proper
salt	Salz	Noun, common, neuter
saltan	salzen	Verb
sama	derselbe, der nämliche	Pronoun
samafraþjis*	samafraþjis*	Adjective
samakuns*	desselben Geschlechts, verwandt	Adjective
samalauþs*	gleich groß	Adjective
samaleiks	gleich	Adjective
samaleiko	auf gleiche Weise, gleich-, ebenfalls	Adverb
samana	zusammen, zugleich	Adverb
samaqiss	Übereinstimmung	Noun, common, feminine
Samareites	Samareites	Noun, proper
Samaria	Samaria	Noun, proper
samasaiwals*	einmütig	Adjective
samaþ	nach einem und demselben Ort hin; zusammen	Adverb
samjan	die den Menschen zu gefallen suchen	Verb
sandjan	senden	Verb
ga-sandjan	entsenden, geleiten	Verb
faura-gasandjan	vorausentsenden	Verb
in-sandjan	entsenden	Verb
miþ-insandjan	mitentsenden	Verb
ga-miþsandjan	mitentsenden	Verb
us-sandjan	aussenden	Verb
Saraipta	Saraipta	Noun, proper
Sarra	Sarra	Noun, proper
sarwa	Waffen	Noun, common, neuter
Satana	Satan	Noun, proper
satjan	setzen	Verb
af-satjan	absetzen, entlassen	Verb
at-satjan	darstellen	Verb
bi-satjan	umgeben	Verb
ga-satjan	hinsetzen, hinstellen, hinlegen	Verb
faura-gasatjan	vorstellen, darstellen	Verb
miþ-satjan	versetzen	Verb
us-satjan	setzten darauf	Verb
saþs*	satt	Adjective
Saudauma	Saudauma	Noun, proper
sauhts*	Krankheit	Noun, common, feminine
sauïl	Sonne	Noun, common, neuter
Saulaumon	Saulaumon	Noun, proper
bi-sauljan	besudeln	Verb
bi-saulnan	besudelt werden	Verb
sauls	Säule	Noun, common, feminine
Saur	Syrer	Noun, common, masculine
Saurais	Saurais	Noun, proper
saurga	Sorge, Kummer	Noun, common, feminine
saurgan	sorgen, bekümmert sein	Verb
Saurini	Syrerin	Noun, common, feminine
sauþa	Grund	Noun, common, feminine
sauþs	Opfer	Noun, common, masculine
sei	sei	<none>
Seidona*	Seidona*	Noun, proper
Seidoneis*	Seidoneis*	Noun, proper
Seimon	Seimon	Noun, proper
Seina	Seina	Noun, proper
sik	sich	Pronoun, personal, reflexive
seinaigairnai	selbstsüchtig	Adjective
*seins	sein, ihr	Pronoun, possesive, reflexive
seiteins	täglich	Adjective
seiþus	spät	Adjective
selei	Tüchtigkeit, Güte	Noun, common, feminine
sels	gut, gütig	Adjective
Sem	Sem	Noun, proper
Seþ*	Seþ*	Noun, proper
sibakþanei	sibakþanei	Foreign word
sibja	Sippenverhältnis, Verwandtschaft	Noun, common, feminine
ga-sibjon	sich mit einem  versöhnen	Verb
sibun	sieben	Numeral, cardinal
sibuntehund	siebzig	Numeral, cardinal
sidon	üben	Verb
sidus	Sitte, Gewohnheit	Noun, common, masculine
sifan	sich freuen, frohlocken	Verb
siggwan	singen; vorlesen, rezitieren	Verb
us-siggwan	vorlesen, rezitieren	Verb
sigis	Sieg	Noun, common, neuter
sigislaun	Siegeslohn	Noun, common, neuter
sigljan	einen mit einem Siegel versehn, ihn siegeln	Verb
faur-sigljan	versiegeln	Verb
ga-sigljan	besiegeln, bestätigen	Verb
sigljo	Siegel	Noun, common, neuter
sigqan	sinken	Verb
dis-sig(g)qan	untersinken	Verb
ga-siggqan	versinken, untergehn	Verb
†sihw	†sihw	Unassigned
sikls*	Sekel	Noun, common, masculine
ana-silan	verstummen	Verb
silba	selbst	Pronoun
Silbanus	Silvanus	Noun, proper
silbasiuneis*	Augenzeuge	Noun, common, masculine
silbawiljis*	freiwillig	Adjective
sildaleik	Staunen, Verwunderung	Noun, common, neuter
sildaleikjan	anstaunen, bewundern	Verb
sildaleiknan	bewundert werden	Verb
sildaleiks	erstaunlich, wunderbar	Adjective
Siloam	Siloam	Noun, proper
silubr	Silber	Noun, common, neuter
silubreins	silbern	Adjective
simle	einst, vordem	Adverb, temporal
sinapis	Senf	Noun, common
sineigs	sineigs	Adjective
sinista	der Älteste	Adjective, Superlative
sinteins	täglich	Adjective
sinteino	immer, allezeit	Adverb
sinþs*	Gang	Noun, common, masculine
Sion	Sion	Noun, proper
siponeis	Schüler, Jünger	Noun, common, masculine
siponjan	jemandes Schüler sein	Verb
sitan	sitzen	Verb
and-sitan	scheuen, Rücksicht nehmen	Verb
bi-sitan	herumsitzen, herumwohnen	Verb
bisitands	Nachbar	Noun, common, masculine
dis-sitan	ergreifen	Verb
ga-sitan	sich niedersetzen, Platz nehmen	Verb
us-sitan	sich aufsetzen, sich aufrichten	Verb
sitls	Sitz	Noun, common, masculine
siujan	nähen	Verb
siukan	siechen, krank sein	Verb
siukei	Krankheit	Noun, common, feminine
siuks	krank, schwach	Adjective
siuns	Gesicht, das Sehen, Sehkraft; Gestalt, sinnfällige Erscheinung; Augenschein; Gesicht, Vision	Noun, common, feminine
skaban	schaben, scheren	Verb
bi-skaban	schaben, scheren	Verb
skadus	Schatten	Noun, common, masculine
ufar-skadwjan	überschatten	Verb
skaftjan	sich bereit machen	Verb
skaidan	scheiden, trennen	Verb
af-skaidan	absondern, abtrennen	Verb
dis-skaidan	zerteilen	Verb
ga-skaidan	sich zurückziehn	Verb
ga-skaidnan	geschieden werden	Verb
skal	schuldig sein, sollen	<none>
skalja*	Ziegel	Noun, common, feminine
skalkinassus	Knechtschaft, Dienst; Gottesdienst	Noun, common, masculine
skalkinon	einem dienen	Verb
miþ-skalkinon	Mitknecht sein, mitdienen	Verb
skalks	Knecht, Diener	Noun, common, masculine
skaman	sich schämen	Verb
ga-skaman	beschämt werden	Verb
skanda	Schande	Noun, common, feminine
ga-skapjan	erschaffen	Verb
Skariotau	Skariotau	<none>
us-skarjan	daß sie nüchtern werden, zur Besinnung kommen aus den Schlingen des Teufels	Verb
skattja	Wechsler	Noun, common, masculine
skatts	Geld, Geldstück; Mine	Noun, common, masculine
†skaþaila	schädlich	<none>
skaþis	Schaden, Unrecht	Noun, common, neuter
skaþjan	schaden	Verb
ga-skaþjan	einem Schaden zufügen in	Verb
skaþuls	schädlich	Adjective
skaudaraip	Riemen	Noun, common
skauns*	anmutig	Adjective
skauneis*	skauneis*	Adjective
skaurpjo	Skorpion	Noun, common, feminine
skauta	Zipfel	Noun, common
[us-skaujan]	daß sie nüchtern werden, zur Besinnung kommen aus den Schlingen des Teufels	<none>
skeimam	Leuchte	Noun, common
skeinan	scheinen, leuchten; aufblitzen	Verb
bi-skeinan	umleuchten	Verb
skeireins	Auslegung, Erklärung	Noun, common, feminine
ga-skeirjan	erklären	Verb
skeirs	klar, deutlich	Adjective
skewjan	wandern	Verb
skildus*	Schild	Noun, common, masculine
skilja*	Fleischer	Noun, common, masculine
skilliggs	Schilling	Noun, common, masculine
skip	Schiff	Noun, common, neuter
af-skiuban	verstoßen, von sich wegstoßen	Verb
skohs	Schuh	Noun, common, masculine
skohsl	böser Geist, Dämon	Noun, common, neuter
dis-skreitan	etw. zerreißen	Verb
dis-skritnan	zerreißen	Verb
skufta	Haupthaar	Noun, common
skuggwa	Spiegel	Noun, common, masculine
skula	Schuldner, der Schuldige	Noun, common, masculine
skulan	schuldig sein, sollen	Verb
skūra	Schauer	Noun, common, feminine
Skwþus	Skwþus	Noun, proper
slahals	Raufbold	Noun, common, masculine
slahan	schlagen	Verb
af-slahan	abschlagen	Verb
slahs	Schlag	Noun, common, masculine
slaihts	schlicht; glatt, eben	Adjective
slauhts	das Schlachten	Noun, common, feminine
af-slaupjan	abstreifen, ablegen	Verb
af-slauþjan	in Angst versetzen	Verb
af-slauþnan	erschrecken	Verb
slawan	schweigen	Verb
ana-slawan	verstummen	Verb
ga-slawan	verstummen	Verb
sleiþa	Schaden	Noun, common, feminine
sleiþei	Gefahr	Noun, common, feminine
ga-sleiþjan	beschädigen	Verb
sleiþs*	schlimm, gefährlich	Adjective
sleideis*	sleideis*	Adjective
slepan	schlafen	Verb
ana-slepan	entschlummern, entschlafen	Verb
ga-slepan	entschlummern, entschlafen	Verb
sleps*	Schlaf	Noun, common
fra-slindan	verschlingen, verschlucken	Verb
sliupan	schleichen, schlüpfen	Verb
uf-sliupan	einschleichen	Verb
smairþr*	Fett	Noun, common, neuter
smakka	Feige	Noun, common, masculine
smakkabagms	Feigenbaum	Noun, common, masculine
smalista	der Kleinste	Adjective, Superlative
smarna	Mist, Kot	Noun, common, feminine
bi-smeitan	bestreichen	Verb
ga-smeitan	aufstreichen auf	Verb
ga-smiþon	 bewirken	Verb
smwrn*	Myrrhe	Noun, common, neuter
snaga	Gewand, Mantel	Noun, common, masculine
snaiws	Schnee	Noun, common, masculine
at-snarpjan	anfassen, anrühren	Verb
sneiþan	schneiden; ernten	Verb
†af-sneiþan	†af-sneiþan	Verb
uf-sneiþan	schlachten	Verb
sniumjan	eilen	Verb
ga-sniumjan	hineilen, kommen	Verb
sniumundo	eilends	Adverb
sniumundos	eiliger	Adverb, Comparative
sniwan	eilen	Verb
du-atsniwan	hinzueilen	Verb
bi-sniwan	zuvorkommen	Verb
faur-bisniwan	vorangehn	Verb
faur-sniwan	vorwegnehmen	Verb
ga-sniwan	ereilen, gelangen zu	Verb
snorjo	Korb	Noun, common, feminine
snutrei	Weisheit	Noun, common, feminine
snutrs*	weise	Adjective
so	der, dieser	<none>
sokareis	Forscher	Noun, common, masculine
sokeins	das Suchen	Noun, common, feminine
sokjan	suchen	Verb
ga-sokjan	aufsuchen	Verb
miþ-sokjan	mitdisputieren	Verb
us-sokjan	erforschen	Verb
sokns	Disputation, Streitfrage, Grübelei	Noun, common, feminine
Soseipatrus	Soseipatrus	Noun, proper
soþa	Sättigung	Noun, common
ga-soþjan	ersättigen	Verb
spaikulatur	Späher, Ordonnanz	Noun, common
spaiskuldra	Speichel	Noun, common
sparwa	Sperling	Noun, common, masculine
spaurds	Rennbahn	Noun, common, feminine
speiwan	speien	Verb
and-speiwan	entgegenspeien	Verb
bi-speiwan	bespeien	Verb
ga-speiwan	ausspeien	Verb
spediza*	spät	Adjective, Comparative
spedists	der jüngste Tag	Adjective, Superlative
spedumists	spedumists	Adjective, Superlative
spilda	Tafel	Noun, common, feminine
spill	Sage, Fabel	Noun, common, neuter
spilla	Verkündiger	Noun, common, masculine
spillon	künden	Verb
ga-spillon	verkünden	Verb
þiuþ-spillon	Gutes, frohe Botschaft künden	Verb
us-spillon	verkünden, erzählen	Verb
waila-spillon	verkünden, erzählen	Verb
spinnan	spinnen	Verb
sprauto	schnell, bald	Adverb
spwreidans	aus Binsen o. Palmblättern geflochtener Korb	Noun, common, masculine
stabeis	Grundstoffe, Elemente	Noun, common, masculine
†us-stagg	stich aus	Verb
ga-stagqjan	etwas anstoßen an	Verb
Staifanus	Staifanus	Noun, proper
staiga	Steig, Weg	Noun, common, feminine
stainahs	steinig	Adjective
staineins	steinern	Adjective
stainjan	steinigen	Verb
stains	Stein	Noun, common, masculine
stairno	Stern	Noun, common, feminine
stairo	die Unfruchtbare	Noun, common, feminine
staks	Mal, Wundmal	Noun, common, masculine
and-staldan	einen versehn mit	Verb
ga-staldan	erwerben, bekommen	Verb
stamms	lallend, stammelnd	Adjective
standan	stehn	Verb
af-standan	abstehn, ablassen, abfallen	Verb
and-standan	entgegenstehn, widerstehn, widerstreiten	Verb
at-standan	dabei stehn	Verb
bi-standan	herumstehn, umringen	Verb
faura-standan	Vorsteher	Verb
ga-standan	stehn bleiben, halt machen	Verb
in-standan	daß der Tag bevorsteht	Verb
miþ-standan	zusammenstehn mit	Verb
twis-standan	sich trennen, Abschied nehmen von	Verb
us-standan	sich erheben, aufbrechen, auferstehn	Verb
staþa	Ufer, Gestade	Noun, common
staþs	Stätte, Ort ; Raum, Platz	Noun, common, masculine
staua	Gericht, Urteil, Streitsache	Noun, common, feminine
staua	Richter	Noun, common, masculine
stauastols	Richterstuhl	Noun, common, masculine
ga-staurknan	vertrocknen	Verb
and-staurran	sie bezeigten ihr Unwillen	Verb
stautan	stoßen an	Verb
steigan	steigen	Verb
at-steigan	hinabsteigen	Verb
ga-steigan	hineinsteigen	Verb
ufar-steigan	darüber empor steigen	Verb
us-steigan	emporsteigen	Verb
stibna	Stimme	Noun, common, feminine
[usstigg]	stich aus	<none>
stigqan	stoßen	Verb
bi-stigqan	anstoßen an	Verb
ga-stiggqan	anstoßen	Verb
stikls	Becher, Kelch	Noun, common, masculine
stiks*	Stich, Punkt	Noun, common, masculine
stilan	stehlen	Verb
stiur	Stier, Kalb	Noun, common, masculine
stiurjan	aufstellen, geltend machen	Verb
stiwiti*	Geduld, geduldiges Ertragen	Noun, common, neuter
ana-stodjan	anfangen, anheben	Verb
du-stodjan	anfangen, anheben	Verb
stojan	stojan	Verb
ga-stojan	ein Urteil abgeben über urteilen	Verb
stols	Stuhl, Thron	Noun, common, masculine
stomin	Wesen, Gegenstand, Zuversicht, Erwartung	Noun, common
[ga-stoþan]	aufrecht erhalten	Verb
straujan	streuen	Verb
ga-straujan	bestreuen	Verb
uf-straujan	darunterstreuen, únterbreiten	Verb
striks	Strich	Noun, common, masculine
stubjus	Staub	Noun, common, masculine
sulja*	Sohle	Noun, common, feminine
ga-suljan	das Fundament legen, begründen	Verb
suman	teils __ teils __ teils	Adverb
sums	irgend einer, ein gewisser, jemand, einer	Pronoun, indefinite
sundro	abgesondert, besonders, allein	Adverb
sunja	Wahrheit	Noun, common, feminine
Sunjaifriþas	Sunjaifriþas	Noun, proper
sunjeins	wahr, wahrhaft	Adjective
sunjis*	wahrhaft	Adjective
sunjon	entschuldigen	Verb
ga-sunjon	rechtfertigen	Verb
sunjons	Verteidigung	Noun, common, feminine
sunno	Sonne	Noun, common
suns	alsbald, plötzlich, auf einmal	Adverb
sunsaiw	sogleich	Adverb
sunsei	sobald als	Conjunction
sunus	Sohn	Noun, common, masculine
supon	würzen	Verb
ga-supon	würzen	Verb
†suqnis	wegen deines Magens	Noun, common
Susanna	Susanna	Noun, proper
sutis	nachgiebig, mild	Adjective
suþjan	kitzeln	Verb
suþjon	suþjon	Verb
swa	so	Adverb
swaei	so daß, daher, also	Conjunction
af-swaggwjan	schwankend machen	Verb
swah	so 	Adverb
swaihra	Schwiegervater	Noun, common, masculine
swaihro	Schwiegermutter	Noun, common, feminine
af-swairban	abwischen, auslöschen	Verb
bi-swairban	abwischen, abtrocknen mit	Verb
swalauþs	so groß	Adjective
swaleiks	so beschaffen, ein solcher	Adjective
swamm	Schwamm	Noun, common
swaran	schwören	Verb
bi-swaran	beschwören	Verb
ufar-swaran	falsch schwören	Verb
sware	ohne Grund, vergebens, umsonst	Adverb
swartiza	Tinte	Noun, common
swartizla	swartizla	<none>
swarts	schwarz	Adjective
swaswe	sowie, gleichwie, wie	Adverb
swaþþan	so nun	Unassigned
swau	so	Unassigned
swe	wie	Adverb
swegniþa	Jubel, Frohlocken	Noun, common, feminine
swegnjan	jubeln, triumphieren	Verb
sweiban	ablassen	Verb
swein	Schwein	Noun, common, neuter
sweran	ehren	Verb
ga-sweran	verherrlichen	Verb
un-sweran	verunehren, beschimpfen	Verb
sweriþa	Ehre	Noun, common, feminine
swers	geehrt, geachtet	Adjective
swes	eigen, angehörig	Adjective
swes	Eigentum, Vermögen	Noun, common, neuter
sweþauh	doch zwar, wenigstens	Particle
swibla	Schwefel	Noun, common
swiglja*	Flötenspieler	Noun, common, masculine
swiglon	Flöte blasen, aufspielen	Verb
swigniþa, swignjan	Jubel, Frohlocken	<none>
swiknei	Reinheit, Keuschheit	Noun, common, feminine
swikneins*	Reinigung	Noun, common, feminine
swikniþa	Reinheit, Keuschheit	Noun, common, feminine
swikns	rein, unschuldig; unsträflich	Adjective
ga-swikunþjan	etw. bekannt geben	Verb
swikunþs	offenkundig, offenbar, bekannt	Adjective
swiltan	im Sterben liegen	Verb
ga-swiltan	sterben	Verb
miþ-gaswiltan	miþ-gaswiltan	Verb
swinþei	Stärke, Kraft	Noun, common, feminine
ga-swinþjan	stärken	Verb
in-swinþjan	stärken	Verb
swinþnan	stark werden	Verb
ga-swinþnan	erstarken	Verb
swinþs	stark, kräftig, gesund	Adjective
swistar	Schwester	Noun, common, feminine
Swmaion	Swmaion	Noun, proper
swnagogafaþs*	Synagogenvorsteher	Noun, common, masculine
swnagoge*	swnagoge*	Noun, common, feminine
Swntwke*	Swntwke*	Noun, proper
swogatjan	seufzen	Verb
ga-swogjan	erseufzen	Verb
uf-swogjan	aufseufzen	Verb
Swria*	Swria*	Noun, proper
swultawairþja	dem Tode nahe	Noun, common, masculine
swumfsl	Teich	Noun, common, neuter
tagl	Haar	Noun, common, neuter
tagr	Zähre, Träne	Noun, common, neuter
tagrjan	weinen	Verb
tahjan	reißen, zerren	Verb
dis-tahjan	zerstreuen	Verb
taihswa	rechts	Adjective
taihswa	die Rechte	Noun, common, feminine
taihun	zehn	Numeral, cardinal
taihunda	der zehnte	Numeral, ordinal
taihuntaihundfalþs	hundertfältig	Adjective
taihuntehund	 Hundert	Numeral, cardinal
taihunteweis*	mit fünf zehnreihigen  Hundert	Adjective
taikn	Anzeichnen	Noun, common, neuter
taiknjan	einem etwas Zeigen	Verb
ga-taiknjan	ein Zeichen geben, belehren	Verb
us-taiknjan	bezeichnen; auszeichnen; erweisen	Verb
taikns	Zeichen, Wunder	Noun, common, feminine
tainjo	korb	Noun, common, feminine
tains	Zweig	Noun, common, masculine
dis-tairan	zerreißen	Verb
ga-tairan	zerreißen, zerstören, aufheben	Verb
Tairtius	Tairtius	Noun, proper
taitrarkes	taitrarkes	Noun, common
taleiþa	Mägdlein	Foreign word
talzeins*	Lehre, Unterweisung	Noun, common, feminine
talzjan	lehren, ziehen, unterrichten	Verb
talzjands	Lehrer	Noun, common
ga-talzjan	belehren, erziehen	Verb
ga-tamjan	bezähmen, bezwingen	Verb
tandjan	brennen machen, zünden	Verb
ga-tandjan	mit einem Brandmal versehn	Verb
in-tandjan	in Brand setzen, verbrennen	Verb
ga-tarhjan	kennzeichnen	Verb
tarmjan	brich los, brich in Jubel aus	Verb
ga-tarnjan	berauben	Verb
taui	Werk, Tat	Noun, common, neuter
taujan	tun, machen	Verb
ga-taujan	, vollbringen, bewirken	Verb
missa-taujan	Übeltäter	Verb
af-taurnan	abreißen	Verb
dis-taurnan	zerreißen	Verb
ga-taurnan	was zu nichte wird, das Vergängliche	Verb
Teibairius	Teibairius	Noun, proper
ga-teihan	anzeigen, verkündigen	Verb
faura-gateihan	vorherverkündigen, vorhersagen	Verb
teikan	anrühren	<none>
Teimaius	Teimaius	Noun, proper
Teimauþaius	Teimauþaius	Noun, proper
Teitus	Teitus	Noun, proper
tekan	anrühren	Verb
at-tekan	berühren	Verb
tewa*	Ordnung	Noun, common, feminine
ga-tewjan	durch Wahl bestimmt, verordnet	Verb
Tibairiadau	Tibairiadau	Noun, proper
Tibairiadeis	Bewohner von Tiberias	Noun, proper
tigjus*	Dekaden; bildet die Zehner von	Unassigned
and-tilon	einem anhangen	Verb
ga-tilon	erlangen	Verb
ga-gátilon	zusammenfügen	Verb
til	damit sie Gelegenheit fänden ihn anzuklagen	Unassigned
ga-timan	geziemen für 	Verb
timbrjan	bauen	<none>
timreins	Erbauung	Noun, common, feminine
timrja	Zimmermann	Noun, common, masculine
timrjan	bauen	Verb
ana-timrjan	daraufbauen	Verb
ga-timrjan	erbauen	Verb
miþ-gatimrjan	mit	Verb
tiuhan	ziehn, führen	Verb
af-tiuhan	wegziehn	Verb
at-tiuhan	herbeiziehn, herbeiführen, herbeibringen	Verb
inn-attiuhan	hineinziehn, hineinführen	Verb
bi-tiuhan	 umherführen	Verb
ga-tiuhan	wegziehn, wegführen	Verb
miþ-gatiuhan	mit	Verb
us-tiuhan	hinausführen, wegführen	Verb
Tobeias	Tobeias	Noun, proper
Trakauneitidaus	Trakauneitidaus	Noun, proper
trauains	Vertrauen, Zuversicht	Noun, common, feminine
trauan	trauen, Zutrauen haben	Verb
ga-trauan	vertrauen	Verb
Trauadai	Trauadai	Noun, proper
trausti	Bündnis, Bund	Noun, common, neuter
triggwa	Bündnis, Bund	Noun, common, feminine
triggws	treu, zuverlässig	Adjective
triggwaba	treulich, zuverlässig	Adverb, Comparative
trigo	Trauer	Noun, common, feminine
ana-trimpan	einen bedrängen	Verb
triu	Holz, Prügel	Noun, common, neuter
triweins	hölzern	Adjective
trudan	treten	Verb
ga-trudan	zertreten	Verb
in-trusgjan	einpfropfen	Verb
ufar-trusnjan	überstreuen	Verb
tuggl	Gestirn	Noun, common, neuter
tuggo	Zunge	Noun, common, feminine
tulgiþa	Festigkeit, Sicherheit; Fundament ; Feste, Bollwerk	Noun, common, feminine
tulgjan	festigen, stärken	Verb
ga-tulgjan	befestigen, bestärken	Verb
tulgus	fest, beständig	Adjective
tundnan	brennen	Verb
in-tundnan	verbrennen	Verb
tunþus	Zahn	Noun, common, masculine
twai	twai	Numeral, cardinal
twalibwintrus	zwölfjährig	Adjective
twalif	zwölf	Numeral, cardinal
tweifleins	das Zweifeln	Noun, common, feminine
tweifljan	zweifeln o. Zweifel erregen	Verb
tweifl	Zweifel	Noun, common
tweihnai	zwischen beiden Grenzen	Numeral, other
twisstass	Zwistigkeit	Noun, common, feminine
Twkeikus	Twkeikus	Noun, proper
Twra*	Twra*	Noun, proper
Þaddaius	Þaddaius	Noun, proper
þadei	wohin	Adverb
þagk*	Dank	<none>
þagkjan	denken, überlegen	Verb
and-þagkjan	mir fällt ein, was ich tun soll	Verb
bi-þagkjan	etw. bedenken	Verb
þahains	das Schweigen	Noun, common, feminine
þahan	schweigen	Verb
ga-þahan	verstummen	Verb
þāho	Lehm	Noun, common, feminine
Þaiaufeilus	Þaiaufeilus	Noun, proper
þairh	durch	Preposition, +A
þairko	Loch, Nadelöhr	Noun, common, neuter
ga-þairsan	verdorren	Verb
Þaissaloneikai	Þaissaloneikai	Noun, proper
Þaissalauneikaie	Þaissalauneikaie	Noun, proper
þan	dann, darauf	Adverb, temporal
þanamais	weiter, noch mehr	Adverb
þanaseiþs	weiter, noch	Adverb
þande	so lange als	Conjunction
þanei	wann	Conjunction
uf-þanjan	ausdehnen, sich ausstrecken	Verb
þank	Dank	Noun, common
þannu	ja, wohl, also darum	Adverb
þanuh	þanuh	Adverb
þar	dort	Adverb, locative
Þara	Þara	Noun, proper
þarba	Mangel, Armut	Noun, common, feminine
ga-þarban	sich enthalten	Verb
þarbs	nötig	Adjective
þarei	wo	Adverb
þarf	nötig haben, bedürfen, Mangel leiden	<none>
þarihs*	ungewalkt	Adjective
þaruh	da	Adverb
þata	der, dieser	<none>
þatain	das eine	Unassigned
þatainei	nur	Adverb
þatei	daß	Conjunction
þat-ist	das ist, nämlich	Unassigned
þatuh	der u. kein andrer, eben der	<none>
þaþro	daher, von da	Adverb
þaþroei	von wannen	Adverb
þaþroh	von da, daher	Adverb
þau	als	Unassigned
þauhjabai	wenn auch	Conjunction
þaurban*	nötig haben, bedürfen, Mangel leiden	Verb
þaurfts	nötig	Adjective
þaurfts	Bedürfnis, Not	Noun, common, feminine
þaurneins	von Dornen	Adjective
þaurnus	Dorn	Noun, common, masculine
þaurp	bebautes Land, Acker	Noun, common, neuter
þaursjan	mich dürstet	Verb
af-þaursjan	dursten	Verb
ga-þaursnan	verdorren, vertrocknen	Verb
þaurstei	Durst	Noun, common, feminine
þaursus	dürr	Adjective
þe	um so	Unassigned
þeei	darum, daß	Unassigned
þei	so lange als	Particle
þeihan	gedeihn, Fortschritte machen	Verb
ga-þeihan	vorwärtskommen	Verb
ufar-þeihan	übertreffen	Verb
þeihs	Zeit	Noun, common, neuter
þeiƕo	Donner	Noun, common, feminine
þeins	dein	Pronoun, possesive
þewisa	Knechte	Noun, common, neuter
at-þinsan	heranziehn	Verb
þishun	meist, vorzüglich	Adverb
þisƕaduh	wohin auch immer	Adverb
þisƕah	wer auch immer	<none>
þisƕaruh	wo auch immer	Adverb
þisƕazuh	wer auch immer	Pronoun, indefinite
þiubi	Diebstahl	Noun, common, neuter
þiubjo	verstohlen, heimlich	Adverb
þiuda	Heiden	Noun, common, feminine
þiudangardi	Königsschloss	Noun, common, feminine
þiudanon	herrschen	Verb
miþ-þiudanon	mitherrschen mit	Verb
þiudans	König	Noun, common, masculine
þiudinassus	Regierung	Noun, common, masculine
þiudisko	heidnisch	Adverb
þiufs	Dieb	Noun, common, masculine
þiumagus	Knecht	Noun, common, masculine
þius*	Haussklave, Diener	Noun, common, masculine
þiuþ	das Gute, die gute Sache	Noun, common, neuter
þiuþeigs	gut, gepriesen	Adjective
þiuþeins	Güte	Noun, common, feminine
þiuqiss	Segen	Noun, common, feminine
þiuþjan	segnen	Verb
ga-þiuþjan	einem  den Segen geben	Verb
un-þiuþjan	fluchen	Verb
þiwadw	Knechtschaft	Noun, common
ana-þiwan	unterjochen, in Dienstbarkeit bringen	Verb
ga-þiwan	unterjochen, in Dienstbarkeit bringen	Verb
þiwi	Magd	Noun, common, feminine
þlahsjan	schrecken	Verb
ga-þlahsnan	erschrecken	Verb
ga-þláihan	ermahnen	Verb
þlaqus	zart	Adjective
þlauhs	Flucht	Noun, common, masculine
þliuhan	þliuhan	Verb
af-þliuhan	wegfliehn	Verb
ga-þliuhan	die Flucht ergreifen, entfliehn	Verb
unþa-þliuhan	entfliehn, einem entrinnen	Verb
Þomas	Þomas	Noun, proper
þrafsteins	Tröstung	Noun, common, feminine
þrafstjan	trösten, mahnen	Verb
ana-þrafstjan	erquicken	Verb
ga-þrafstjan	ga-þrafstjan	Verb
þragjan	laufen	Verb
bi-þragjan	herbeilaufen	Verb
þramstei	Heuschrecke	Noun, common, feminine
þrasabalþei*	Streitsucht	Noun, common, feminine
þreihan	drängen	Verb
ga-þreihan	bedrängen	Verb
þreihsl	Teich	Noun, common, neuter
þreis*	drei	Numeral, cardinal
þridja	der dritte	Numeral, ordinal
þriskan	dreschen	Verb
us-þriutan	einem Beschwerde bringen	Verb
þroþjan	üben	Verb
us-þroþjan	Übung, Stählung	Verb
þrūtsfill	Aussatz	Noun, common, neuter
þrutsfills	aussätzig	Adjective
þu	du	Pronoun, personal
þuei	der du	Pronoun, personal, relative
þugkjan	glauben, meinen; gelten	Verb
þuhtus	Gewissen	Noun, common, masculine
þulains	das Dulden, Leiden, die Geduld	Noun, common, feminine
þulan	dulden	Verb
ga-þulan	erdulden	Verb
us-þulan	erdulden, ertragen	Verb
þūsundi	tausend	Noun, common, feminine
þusundifaþs	Anführer von Tausend	Noun, common, masculine
þuthaurn	Trompete	Noun, common, neuter
þuthaurnjan	trompeten	Verb
þwahan	etw. waschen	Verb
af-þwahan	sich abwaschen	Verb
bi-þwahan	sich abwaschen	Verb
us-þwahan	etwas auswaschen, abwaschen	Verb
þwahl	Bad, Taufe	Noun, common, neuter
þwairhei	Zorn, Streit, Streitigkeit	Noun, common, feminine
þwairhs	zornig	Adjective
þwastiþa	Sicherheit	Noun, common, feminine
ga-þwastjan	befestigen	Verb
þwmiama	Rauchopfer	Noun, common, masculine
-u	-u	Particle, enclitic
ubils	übel, böse	Adjective
ubiltojis	übeltäterisch	Adjective
ubilwaurdjan	schmähn	<none>
ubilwaurds	schmähsüchtig	Adjective
ubizwa*	Halle	Noun, common, feminine
uf	unter	Preposition, +AD
ufaiþeis*	durch Eid verpflichtet, verbunden	Adjective
ufar	über	Preposition, +AD
ufarassjan	überfließend, überschwänglich machen	Verb
ufarassus	Überfluß, Übermaß	Noun, common, masculine
ufarfullei	Überfülle, Überfluß	Noun, common, feminine
ufarfulls	übervoll	Adjective
ufargudja	Oberpriester	Noun, common, masculine
ufarhauseins	das Überhören, der Ungehorsam	Noun, common, feminine
ufarhiminakunds	himmlisch	Adjective
ufarjaina	darüber hinaus	Unassigned
ufarmaudei	Vergessenheit	Noun, common, feminine
ufarmeleins	Überschrift	Noun, common, feminine
ufarmeli	Überschrift	Noun, common, neuter
ufaro	darüber	Adverb
ufarranneins	Besprengung	Noun, common, feminine
ufarskafts	Erstlingsfrucht	Noun, common, feminine
ufarswara*	Meineidiger	Noun, common, masculine
ufhauseins	Gehorsam	Noun, common, feminine
ufhnaiweins	Unterordnung, Gehorsam	Noun, common, feminine
Ufitahari	Ufitahari	Noun, proper
ufjo	es ist überflüssig für mich euch zu schreiben	Unassigned
ufkunþi	Erkenntnis	Noun, common, neuter
ufswalleins	Aufgeblasenheit, Hochmut	Noun, common, feminine
ufta	oft	Adverb, temporal
ufto	vielleicht	Adverb
ufwaira	die verheiratete Frau	Unassigned
ugkis	uns beide	Pronoun, personal
-uh	und, nun, also	Particle, enclitic
uhtedun	sich fürchten vor 	<none>
uhteigs	Zeit habend	Adjective
uhteigo	zur rechten Zeit	Adverb, Comparative
uhtiugs	gelegen	Adjective
uhtwo	Morgendämmerung	Noun, common, feminine
ulbandus	Kamel	Noun, common
unagands	furchtlos	Participle, present
unagein	furchtlos	Unassigned
unairkns	unheilig, gottlos	Adjective
unaiwisks	der sich nicht zu schämen braucht, ohne Schande	Adjective
unanasiuniba	unsichtbar	Adverb
unandhuliþs*	unenthüllt	Participle, past
unandsakans	unbestritten	Participle, past
unandsoks*	unbestreitbar	Adjective
unatgāhts	unzugänglich	Adjective
unbairands	nicht tragend	Participle, present
unbarnahs	kinderlos	Adjective
unbaurans	ungeboren	Participle, past
unbeistei*	das Ungesäuertsein	Noun, common, feminine
unbeistjoþs*	ungesäuert	Participle, past
unbiari*	wildes Tier, Bestie	Noun, common, neuter
unbilaistiþs*	unaufspürbar, unbegreiflich	Participle, past
unbimait	Nichtbeschneidigung, Vorhaut	Noun, common, neuter
unbimaitans	unbeschnitten	Participle, past
unbrūks	unbrauchbar	Adjective
und	bis zu	Preposition, +AD
undar	unter etw	Preposition, +A
[undaristo]	das Innere	Adjective, Superlative
undarleija	der Allergeringste	Noun, common, masculine
undaro	unter	Preposition, +D
undaurnimats	Frühstück	Noun, common, masculine
undiwanei	Unsterblichkeit	Noun, common, feminine
unfagrs	unpassend, undankbar	Adjective
unfairina	tadellos	Adjective
unfairinodaba	untadelig	Adverb
unfairlaistiþs	unaufspürbar, unerforschlich	Participle, past
unfaurs	geschwätzig	Adjective
unfaurweis	unvorsätzlich, ohne Vorbedacht	Adjective
unfraþjands	unverständig	Participle, present
unfreideins	Schonungslosigkeit, Härte	Noun, common, feminine
unfrodei	Unverstand, Torheit	Noun, common, feminine
unfroþs	unverständig	Adjective
ungafairinonds	tadellos; unbescholten	Participle, present
ungafairinoþs	tadellos	Participle, past
ungahabands	zügellos, sich nicht beherrschend	Participle, present
ungahobains	Unmäßigkeit, Unenthaltsamkeit	Noun, common, feminine
ungaƕairbs	unfügsam, ungehorsam	Adjective
ungakusans	nicht probehaltig, verwerflich	Participle, past
ungalaubeins	Unglaube, Ungehorsam	Noun, common, feminine
ungalaubjands	ungläubig, ungehorsam	Participle, present
ungalaufs	wertlos	Adjective
ungaraihtei	Gesetzlosigkeit, Ungerechtigkeit	Noun, common, feminine
ungasaiƕans	ungesehn, unsichtbar	Participle, past
ungastoþs	ohne festen Stand, ohne bleibende Stätte	Adjective
ungatass	ungeordnet, zügellos	Adjective
ungatewiþs*	ungeordnet	Participle, past
ungawagiþs*	unbewegt, unbeweglich	Participle, past
unhabands	nicht habend	Participle, present
unhaili	Schwäche, Krankheit	Noun, common, neuter
unhails	krank	Adjective
unhanduwaurhts	nicht mit der Hand gemacht	Adjective
unhindarweis	ungeheuchelt	Adjective
unhrainei	Unreinigkeit	Noun, common, feminine
unhrainiþa	Unreinigkeit	Noun, common, feminine
unhrains	unrein; ungebildet	Adjective
unhulþa	Unhold, Teufel	Noun, common, masculine
unhulþo	Unholdin, Dämon	Noun, common, feminine
unhunslags	ohne Opfer, unversöhnlich	Adjective
unƕapnands	unauslöschlich	Participle, present
unƕeila	unablässig	Adjective
unkarja	sorglos	Adjective
unkaureins*	unkaureins*	Noun, common, feminine
unkja	Unze	Noun, common, masculine
unkunnands	nicht kennend, unwissend	Participle, present
unkunþi	Unkunde	Noun, common, neuter
unkunþs	unbekannt	Adjective
unledi	Armut	Noun, common, neuter
unleþs*	arm	Adjective
unliufs*	ungeliebt, unlieb	Adjective
unliugaiþs*	unverheiratet	Participle, past
unliugands	nicht lügend	Participle, present
unliuts	ungeheuchelt, ohne Falsch	Adjective
unlustus	Unlust	Noun, common, masculine
unmahteigs	ohnmächtig, schwach	Adjective
unmahts	Ohnmacht, Schwäche, Krankheit	Noun, common, feminine
unmanariggwai	ungezähmt, wild oder unfreundlich, barsch	Adjective
unmanwus	unvorbereitet	Adjective
unmildjai	lieblos	Adjective
unnutjans	unnütz, töricht	Adjective
unqeniþs*	unbeweibt	Participle, past
unqeþs*	unaussprechlich	Adjective
unriurei	Unvergänglichkeit	Noun, common, feminine
unriureis*	unvergänglich	Adjective
unriurs*	unriurs*	Adjective
unrodjands	nicht redend, stumm	Participle, present
[unsahtaba]	unbestritten	Adverb
unsaiƕands	nicht sehend	Participle, present
unsaltans	ungesalzen	Participle, past
unsar	unser	Pronoun, possesive
unselei	Bosheit, Schlechtigkeit	Noun, common, feminine
unsels	übel, böse	Adjective
unsibjis*	ungesetzlich, gottlos	Adjective
unskaus*	laßt uns nüchtern sein	Adjective
unsuti*	Aufstand	Noun, common, neuter
unsweibands	unaufhörlich	Participle, present
unswerei	Unehre	Noun, common, feminine
unsweriþa	Unehre	Noun, common, feminine
unswers	nicht geachtet, verachtet	Adjective
unswikunþs*	unbekannter	Adjective
untals	unfügsam, unbotmäßig, ungehorsam	Adjective
unte	bis, so lange als	Conjunction
untilamalsks	voreilig, unbesonnen	Adjective
untriggws	untreu	Adjective
unþiuda	Unvolk, Nicht	Noun, common, feminine
unþiuþ	das Böse	Noun, common, neuter
unþwahans	ungewaschen	Participle, past
unufbrikands	unanstößig	Participle, present
unuhteigo	zur Unzeit	Adverb
unuslaisiþs	unbelehrt	Participle, past
unusspilloþs*	nicht auszuerzählen, unerforschlich	Participle, past
unwahs	tadellos	Adjective
unwairþaba	unwürdig	Adverb
unwammei	Unbeflecktheit	Noun, common, feminine
unwamms	fleckenlos, tadellos	Adjective
unwaurstwo	untätig, müßig	Noun, common, feminine
unweis	ungebildet, unwissend	Adjective
unweniggo	unerwartet, plötzlich	Adverb
unwerein	Unwille	Noun, common, feminine
[unwiss*]	ungewiß, ins ungewisse	Adjective
unwita	Unwissender, Unverständiger	Noun, common, masculine
unwitands	unwissend	Participle, present
unwiti	Unwissenheit, Unverstand	Noun, common, neuter
unwunands	beängstigt, bekümmert	Participle, present
ur	aus, von 	<none>
urrists	Auferstehung	Noun, common, feminine
urrugks	verworfen	Adjective
urruns	Abtritt	Noun, common, masculine
urruns	Ausgang	Noun, common, feminine
us	aus, von 	Preposition, +D
usbalþei	Frechheit; fortwährende Zänkerei	Noun, common, feminine
usbeisnei	Geduld, Langmut	Noun, common, feminine
usbeisneigs	geduldig, langmütig	Adjective
usbeisns	Erwartung; Geduld, Langmut	Noun, common, feminine
us-bloteins	Bitte, Flehn	Noun, common, feminine
usdaudei	Ausdauer; Eifer	Noun, common, feminine
usdauþs*	eifrig	Adjective
usdaudoza	usdaudoza	Adjective, Comparative
usdaudo	eifrig	Adverb
usdrusts	rauhe Wege	Noun, common, feminine
usfairina	tadellos	Adjective
usfarþo	Ausfahrt	Noun, common, feminine
usfilh	Begräbnis	Noun, common, neuter
usfilma	sie entsetzten sich über	Adjective
usfilmei	Entsetzen	Noun, common, feminine
usfodeins	Nahrung	Noun, common, feminine
usfulleins	Erfüllung	Noun, common, feminine
usgrudja	mutlos	Adjective
ushaista	Mangel leidend	Adjective
uskunþs	bekannt, offenbar	Adjective
uslauseins	Erlösung	Noun, common, feminine
usliþa	gichtbrüchig, Gichtbrüchiger	Adjective
†uslukns	erschließen, öffnen	<none>
usluk*	Eröffnung, Öffnung	Noun, common, neuter
usluneins*	Erlösung	Noun, common, feminine
usmet*	Lebensführung; Lebenswandel	Noun, common, neuter
usqiss	Beschuldigung, Anklage	Noun, common, feminine
ussateins	Ursprung	Noun, common, feminine
ussindo	am meisten, besonders	Adverb
[usskawai]	laßt uns nüchtern sein	<none>
usstass	Auferstehung	Noun, common, feminine
usstiurei	Zügellosigkeit, Lüderlichkeit	Noun, common, feminine
usstiuriba	zügellos	Adverb
ustaikneins	Auszeichnung, Bezeichnung; Bekanntmachung; Anzeichen, Beweis	Noun, common, feminine
ustauhts	Vollendung, Vervollkommnung; Ende; Erfüllung	Noun, common, feminine
usþroþeins	Übung, Stählung	Noun, common, feminine
usþulains	Geduld	Noun, common, feminine
uswahsans	erwachsen	Participle, past
uswahsts	Wachstum	Noun, common, feminine
uswalteins	Umwälzung; Zusammensturz; Zerstörung; Untergang	Noun, common, feminine
uswandi*	das Abwenden, Irreleiten	Noun, common, feminine
uswaurhts	gerecht	Adjective
uswaurhts	Gerechtigkeit	Noun, common, feminine
uswaurpa	Auswurf; Verwerfung; Fehlgeburt	Noun, common, feminine
usweihs	außer der Weihe	Adjective
uswena	hoffnungslos	Adjective
uswiss	losgebunden	Adjective
uswissi*	Leichtfertigkeit, Eitelkeit	Noun, common, neuter
ūt	hinaus, heraus	Adverb, directional
ūta	außerhalb, draußen	Adverb, locative
ūtana	von außen, außen	Adverb, directional
ūtaþro	von außen	Adverb, directional
uzeta*	Krippe	Noun, common, masculine
uz-u, uz-uh	aus, von 	<none>
wadi	Pfand	Noun, common, neuter
wadjabokos	Handschein, Schuldschein	Noun, common, feminine
ga-wadjon	zusammenfügen, verloben	Verb
waggarja	Kopfkissen	Noun, common
waggs*	Paradies	Noun, common, masculine
wagjan	schütteln	Verb
af-wagjan	bewegen, abbringen	Verb
ga-wagjan	einen in Bewegung setzen	Verb
in-wagjan	erregen, aufwiegeln	Verb
us-wagjan	erregen	Verb
wahsjan	wachsen	Verb
ufar-wahsjan	überaus wachsen, sich stark vermehren	Verb
us-wahsjan*	erwachsen	<none>
wahstus	Wuchs	Noun, common, masculine
wahtwom	Wache	Noun, common, feminine
wai	wehe	Interjection
waian	wehn	Verb
bi-waibjan	umwinden, umgeben, umkleiden	Verb
waidedja	Übeltäter, Räuber	Noun, common, masculine
waihjo	Kampf	Noun, common, feminine
waihsta	Winkel, Ecke	Noun, common, masculine
waihstastains	Eckstein	Noun, common, masculine
waiht	nichts	Noun, common, neuter
waihts	Ding, Sache, Etwas	Noun, common
wáila	wohl, gut	Adverb
wailadeþs*	Wohltat	Noun, common, feminine
wailamerei*	guter Ruf	Noun, common, feminine
wailamereins	Verkündigung	Noun, common, feminine
wailamereis	wohllautend, löblich	Adjective
wailaqiss	Segen	Noun, common, feminine
wailawizns	victus, gute Nahrung	Noun, common, feminine
wainahs	elend, geplagt	Adjective
wainei	daß doch, wenn doch	Interjection
faur-waipjan	verbinden	Verb
waips	Kranz	Noun, common, masculine
wair	Mann	Noun, common, masculine
wairaleiko	männlich	Adverb
wairdus	Gastfreund, Hauswirt	Noun, common, masculine
wairilom	Lippe	Noun, common, feminine
wairpan	werfen	Verb
af-wairpan	etw. wegwerfen	Verb
at-wairpan	hinwerfen	Verb
fra-wairpan	verwerfen, zerstreuen	Verb
ga-wairpan	hinwerfen	Verb
inn-wairpan	hineinwerfen	Verb
us-wairpan	hinauswerfen, wegwerfen, austreiben	Verb
wairs	schlimmer	Adverb, Comparative
wairsiza	schlimmer	Adjective, Comparative
wairþ	Preis	Noun, common
wairþan	werden	Verb
fra-wairþan	verderben	Verb
wairþida	Tüchtigkeit, Fähigkeit	Noun, common, feminine
ga-gáwairþjan	versöhnen mit	Verb
ga-gáwairþnan	sich versöhnen mit	Verb
wairþon	schätzen	Verb
wairþs	wert, würdig, tauglich	Adjective
wait	auf etw. sehn, acht geben, es bewachen, hüten, etw. halten	<none>
waitei	vielleicht, etwa	Adverb
wajamerei	schlechter Ruf	Noun, common, feminine
wajamereins	Lästerung	Noun, common, feminine
wakan	wachen	Verb
þairh-wakan	durchwachen	Verb
us-wakjan	erwecken	Verb
ga-waknan	erwachen	Verb
waldan	walten	Verb
ga-waldan	sich der Herrschaft bemächtigen, einen vergewaltigen	Verb
waldufni	Gewalt, Macht über	Noun, common, neuter
walisa	echt, lauter	Adjective
waljan	wählen	Verb
ga-waljan	erwählen	Verb
waltjan	sich wälzen	Verb
us-waltjan	etw. umwälzen, umstürzen	Verb
us-walugjan	hin und her wälzen	Verb
walus	Stab	Noun, common, masculine
walwison	sich wälzen	Verb
af-walwjan	wegwälzen	Verb
at-walwjan	hinzuwälzen	Verb
faur-walwjan	vorwälzen	Verb
wamba	Bauch, Schoß	Noun, common, feminine
wamme	Fleck	Noun, common
ana-wammjan	beflecken	Verb
wan	Mangel	Noun, common, neuter
wanains	Mangel	Noun, common, feminine
wandjan	wenden	Verb
af-wandjan	abwenden	Verb
at-wandjan	zuwenden	Verb
bi-wandjan	vermeiden	Verb
ga-wandjan	wenden	Verb
in-wandjan	verdrehn	Verb
us-wandjan	sich wegwenden	Verb
wandus	Rute	Noun, common, masculine
waninassus	Mangel	Noun, common, masculine
wans	mangelhaft, fehlend	Adjective
wardja	Wächter	Noun, common, masculine
fra-wardjan	verderben	Verb
warei	Tücke, Verschlagenheit	Noun, common, feminine
wargiþa	Verdammungsurteil, Verurteilung	Noun, common, feminine
ga-wargjan	einen verurteilen zu 	Verb
warjan	wehren	Verb
warmjan	wärmen	Verb
warai*	behutsam, nüchtern	Adjective
wasjan	einen kleiden	Verb
and-wasjan	entkleiden	Verb
ga-wasjan	bekleiden mit	Verb
wasti*	Kleid	Noun, common, feminine
wato	Wasser	Noun, common, neuter
waurd	Wort	Noun, common, neuter
waurdahs	seiner vernünftigen Natur gemäß	Adjective
waurdajiuka	Wortstreit	Noun, common, feminine
and-waurdjan	widersprechen	Verb
filu-waurdjan	viel Worte machen	Verb
ubil-waurdjan	schmähn	Verb
waurkjan	machen, wirken	Verb
fair-waurkjan	etw. erwirken	Verb
fra-waurkjan	eine Sünde begehen	Verb
ga-waurkjan	bewirken, erwirken, bereiten	Verb
us-waurkjan	ausführen, vollbringen	Verb
waurms	Wurm, Schlange	Noun, common, masculine
waurstw	Werk, Tat; Wirksamkeit	Noun, common, neuter
waurstwa	Arbeiter	Noun, common, masculine
waurstwei	das Tun	Noun, common, feminine
waurstweigs	wirksam	Adjective
waurstwja	Arbeiter	Noun, common, masculine
waurts	Wurzel	Noun, common, feminine
wegs	Erschütterung, Sturm; Wellenschlag, Brandung	Noun, common, masculine
weiha	Priester	Noun, common, masculine
weihan	kämpfen	Verb
and-waihan*	widerstreiten	Verb
weihan	weihen, heiligen	Verb
ga-weihan	weihen, heiligen	Verb
weihiþa	Weihe, Heiligung, Heiligkeit	Noun, common, feminine
weihnan	heilig werden	Verb
weihs	heilig	Adjective
weihs	Dorf, Weiler	Noun, common, neuter
wein	Wein	Noun, common, neuter
weinabasi	Weinbeere	Noun, common, neuter
weinagards	Weingarten, Weinberg	Noun, common, masculine
weinatains	Weinrebe	Noun, common, masculine
weinatriu	Weinstock	Noun, common, neuter
weindrugkja	Weintrinker, Säufer	Noun, common, masculine
weinnas	trunken, Trunkenbold	Unassigned
weipan	kränzen, krönen	Verb
weis	wir	Pronoun, personal
fullaweisjan	überreden	Verb
ga-fullaweisjan	vollenden oder beglaubigen	Verb
ga-weison	heimsuchen, besuchen, besorgen	Verb
fra-weitan	einem Recht verschaffen, ihn rächen an	Verb
in-weitan	die Proskynesis, Verehrung erweisen, begrüßen	Verb
fair-weitjan	gespannt hinblicken auf	Verb
idweitjan	schmähn	Verb
weitwodei	Zeugnis	Noun, common, feminine
weitwodeins	Zeugnisablegung, Zeugnis	Noun, common, feminine
weitwodi	Zeugnis	Noun, common, neuter
weitwodiþa	Zeugnisablegung, Zeugnis	Noun, common, feminine
weitwodjan	zeugen, bezeugen	Verb
miþ-weitwodjan	mitzeugen	Verb
weitwoþs*	Zeuge	Noun, common, masculine
wenjan	warten, hoffen auf 	Verb
faura-wenjan	auf einen vorher hoffen	Verb
ga-wenjan	erwarten, annehmen	Verb
wens	Hoffnung	Noun, common, feminine
wepna	Waffen	Noun, common, neuter
Wereka	Wereka	Noun, proper
tuz-werjan	zweifeln	Verb
un-werjan	unwillig sein, zürnen	Verb
ga-widan	zusammenbinden, verbinden	Verb
in-widan	verleugnen	Verb
widuwairna*	Waise	Noun, common, masculine
widuwo	Witwe	Noun, common, feminine
wigadeinom	Dornpflanzen	Noun, common, feminine
ga-wigan	bewegen	Verb
[wigana]	zum Kriege	Noun, common
wigs	Weg	Noun, common, masculine
wiko	in der Reihenfolge seiner Tagesklasse, da seine Tagesklasse an der Reihe war	Noun, common, feminine
wilja	Wille	Noun, common, masculine
wiljahalþei	Parteilichkeit	Noun, common, feminine
wiljan	wollen	Verb
Wiljariþ	Wiljariþ	Noun, proper
wilþeis	wild	Adjective
wilwa	räuberisch, Räuber	Noun, common, masculine
wilwan	rauben	Verb
dis-wilwan	ausplündern, berauben	Verb
fra-wilwan	fortreißen	Verb
bi-windan	umwinden	Verb
du-gawindan	du-gawindan	Verb
us-windan	flechten	Verb
winds	Wind	Noun, common, masculine
winja	Weide	Noun, common, feminine
winna	Leiden	Noun, common, feminine
winnan	leiden	Verb
ga-winnan	erleiden	Verb
winno	Leiden	Noun, common, feminine
wintrus	Jahr	Noun, common, masculine
winþiskauro	Worfschaufel	Noun, common, feminine
dis-winþjan	zermalmen	Verb
wipja	Kranz	Noun, common, feminine
wis	Meeresstille	Noun, common, neuter
wisan	sein, dasein, existieren	Verb
at-wisan	da sein	Verb
faura-wisan	vorhanden ist	Verb
fra-wisan	verbrauchen, vergeuden	Verb
in-wisan	als der Sabbat vorüber war	Verb
miþ-wisan	beistehn, zu Hilfe kommen	Verb
ufar-wisan	überragend sein	Verb
wisan	sich freuen, schwelgen, schmausen	Verb
bi-wisan	sich freuen, schwelgen, schmausen	Verb
wisan	weilen, bleiben	Verb
ga-wisan	verweilen, verbleiben	Verb
miþ-gawisan	mit einem zusammen verweilen	Verb
þairh-wisan	verbleiben, verharren	Verb
wists	Wesen, Natur	Noun, common, feminine
wit	wit	Pronoun, personal
witan	wissen	Verb
miþ-witan	ich bin mir nichts bewußt	Verb
witan	auf etw. sehn, acht geben, es bewachen, hüten, etw. halten	Verb
witodafasteis	Gesetzeskundiger	Noun, common, masculine
witodalaisareis	Gesetzeslehrer	Noun, common, masculine
witodalaus	gesetzlos	Adjective
witodeigo	gesetzlich	Adverb
witoþ	Gesetz	Noun, common, neuter
witubni	Kenntnis, Erkenntnis	Noun, common, neuter
wiþon	schütteln	Verb
wiþra	wider, gegen	Preposition, +A
wiþrawairþs	gegenüberliegend, entgegengesetzt	Adjective
wiþrus	 Lamm	Noun, common, masculine
wizon	die Schwelgende	Verb
wlaiton	sich umsehn	Verb
wlits	Angesicht; Ansehn, Gestalt	Noun, common, masculine
wlizjan	ins Gesicht schlagen, kasteien	Verb
Wmainaius	Wmainaius	<none>
wokains	das Wachen	Noun, common, feminine
wokra	Zins	Noun, common
wopjan	rufen	Verb
at-wopjan	herbeirufen	Verb
uf-wopjan	aufschreien, ausrufen	Verb
woþeis*	angenehm	Adjective
woþs*	wütend, besessen	Adjective
wraiqs	krumm	Adjective
wraka	Verfolgung	Noun, common, feminine
wrakja	Verfolgung	Noun, common, feminine
wrakjan	verfolgen	Verb
wraks	Verfolger	Noun, common, masculine
wratodus	Reise	Noun, common, masculine
wraton	reisen	Verb
wrekei	Verfolgung	Noun, common, feminine
[wreþus]	Herde	Noun, common, masculine
wrikan	verfolgen	Verb
fra-wrikan	verfolgen	Verb
ga-wrikan	bestrafen, Rache nehmen an 	Verb
ga-wrisqan	Frucht bringen	Verb
writs	Strich	Noun, common, masculine
wriþus	Herde	<none>
wrohjan	anklagen, beschuldigen	Verb
fra-wrohjan	verklagen, verdächtigen	Verb
wrohs	Klage, Anklage gegen	Noun, common, feminine
wruggo	Schlinge	Noun, common, feminine
wulan	wallen, sieden	Verb
wulfs	Wolf	Noun, common, masculine
wulla	Wolle	Noun, common, feminine
wullareis	Tuchwalker	Noun, common, masculine
wulþags	herrlich, wunderbar	Adjective
wulþriza	wertvoller	Adjective, Comparative
wulþrs	Wert	Noun, common, feminine
wulþus	Herrlichkeit	Noun, common, masculine
wulwa	Raub	Noun, common, feminine
[ga-wundon]	verwunden	Verb
wunds	wund	Adjective
wundufni	Geißel, Plage	Noun, common, feminine
wunns	Leiden	Noun, common, feminine
Xafira	Xafira	Noun, proper
Xreskus	Xreskus	Noun, proper
Xristus	Christus	Noun, proper
Zaibaidaius	Zaibaidaius	Noun, proper
Zakarias	Zakarias	Noun, proper
Zakkaius	Zakkaius	Noun, proper
Zauraubabil	Zauraubabil	Noun, proper
Zaxxaius	Zaxxaius	Noun, proper
Zelotes*	Eiferer, Beiname des Simon	Noun, proper
